James	Aaron	M
John	Abad	M
Robert	Abarca	M
Michael	Abbey	M
Mary	Abbott	F
William	Abdul-Wahad	M
David	Abdullah	M
Joseph	Abel	M
Richard	Abell	M
Charles	Abercrombie	M
Thomas	Abernathy	M
Christopher	Abeyta	M
Daniel	Ables	M
Elizabeth	Abner	F
Patricia	Abney	F
Matthew	Abraham	M
Jennifer	Abrahamson	F
George	Abram	M
Linda	Abrams	F
Barbara	Abramson	F
Donald	Abrego	M
Anthony	Abreu	M
Paul	Abshire	M
Mark	AbuArab	M
Edward	Acevedo	M
Steven	Aceves	M
Kenneth	Acker	M
Andrew	Ackerman	M
Margaret	Ackley	F
Joshua	Acosta	M
Brian	Acree	M
Kevin	Acton	M
Susan	Acuna	F
Dorothy	Adair	F
Ronald	Adam	M
Sarah	Adame	F
Timothy	Adams	M
Jessica	Adamson	F
Helen	Adcock	F
Nancy	Addington	F
Betty	Addison	F
Karen	Adkins	F
Jeffrey	Adler	M
Lisa	Adrian	F
Frank	Agee	M
Ryan	Agnew	M
Gary	Agosto	M
Nicholas	Aguayo	M
Jacob	Aguero	M
Anna	Aguiar	F
Sandra	Aguila	F
Eric	Aguilar	M
Stephen	Aguilera	M
Ashley	Aguirre	F
Donna	Ahearn	F
Kimberly	Ahern	F
Ruth	Ahmad	F
Carol	Ahmed	F
Jonathan	Ahn	M
Emily	Ahrens	F
Michelle	Aiello	F
Larry	Aiken	M
Laura	Aikens	F
Amanda	Ainsworth	F
Scott	Akers	M
Raymond	Akin	M
Justin	Akins	M
Melissa	Al-Zawahiri	F
Rebecca	Alam	F
Brandon	Alanis	M
Deborah	Alaniz	F
Stephanie	Alarcon	F
Sharon	Alba	F
Samuel	Albanese	M
Kathleen	Albano	F
Cynthia	Albers	F
Gregory	Albert	M
Benjamin	Alberto	M
Shirley	Alberts	F
Amy	Albertson	F
Patrick	Albin	M
Jack	Albrecht	M
Angela	Albright	F
Catherine	Albritton	F
Henry	Alcala	M
Virginia	Alcantar	F
Katherine	Alcantara	F
Alexander	Alcaraz	M
Walter	Alcorn	M
Dennis	Aldana	M
Jerry	Alden	M
Brenda	Alderman	F
Emma	Alderson	F
Pamela	Aldrich	F
Frances	Aldridge	F
Christine	Alegria	F
Nicole	Alejandro	F
Tyler	Aleman	M
Peter	Alex	M
Rachel	Alexander	F
Douglas	Alexis	M
Samantha	Alfano	F
Janet	Alfaro	F
Carolyn	Alfonso	F
Aaron	Alford	M
Debra	Alfred	F
Alice	Alger	F
Harold	Ali	M
Martha	Alicea	F
Jose	Allan	M
Maria	Allard	F
Marie	Allen	F
Adam	Alley	M
Evelyn	Allgood	F
Heather	Allison	F
Arthur	Allman	M
Nathan	Allred	M
Zachary	Almaguer	M
Diane	Almanza	F
Joyce	Almaraz	F
Julie	Almazan	F
Carl	Almeida	M
Albert	Almond	M
Joan	Almonte	F
Rose	Alonso	F
Christina	Alonzo	F
Kyle	Alston	M
Kelly	Alt	F
Grace	Altamirano	F
Ann	Altman	F
Victoria	Alton	F
Doris	Alva	F
Lauren	Alvarado	F
Jean	Alvarenga	F
Lawrence	Alvarez	M
Judith	Alves	F
Mildred	Alvey	F
Joe	Amador	M
Kathryn	Amaral	F
Willie	Amaro	M
Gerald	Amato	M
Julia	Amaya	F
Cheryl	Ambriz	F
Roger	Ambrose	M
Megan	Amerson	F
Keith	Ames	M
Jeremy	Amezcua	M
Andrea	Amick	F
Terry	Amin	M
Lillian	Ammons	F
Harry	Amos	M
Jacqueline	Amundson	F
Sara	An	F
Teresa	Anaya	F
Ralph	Anders	M
Sean	Andersen	M
Jesse	Anderson	M
Gloria	Andino	F
Hannah	Andrade	F
Janice	Andre	F
Theresa	Andres	F
Roy	Andrew	M
Christian	Andrews	M
Austin	Andrus	M
Louis	Angel	M
Billy	Angeles	M
Judy	Angell	F
Bruce	Angelo	M
Eugene	Angle	M
Beverly	Anglin	F
Olivia	Anguiano	F
Bryan	Angulo	M
Ethan	Annis	M
Denise	Anthony	F
Marilyn	Antoine	F
Amber	Anton	F
Jane	Antonelli	F
Danielle	Antonio	F
Brittany	Aparicio	F
Diana	Apodaca	F
Jordan	Aponte	M
Wayne	Appel	M
Russell	Apple	M
Irene	Appleby	F
Madison	Applegate	F
Annie	Appleton	F
Howard	Aquino	M
Fred	Aragon	M
Lori	Araiza	F
Alan	Arambula	M
Ruby	Arana	F
Philip	Aranda	M
Juan	Arango	M
Florence	Araujo	F
Tiffany	Arbogast	F
Kathy	Arbuckle	F
Louise	Arce	F
Dylan	Arceneaux	M
Lois	Archer	F
Tammy	Archibald	F
Kayla	Archie	F
Natalie	Archuleta	F
Alexis	Ard	F
Crystal	Arellano	F
Vincent	Arena	M
Randy	Arenas	M
Bonnie	Arevalo	F
Phyllis	Arguello	F
Abigail	Argueta	F
Anne	Arias	F
Noah	Armas	M
Bobby	Armbruster	M
Charlotte	Armendariz	F
Erin	Armenta	F
Johnny	Armijo	M
Taylor	Armour	F
Victor	Armstead	M
Gabriel	Armstrong	M
Phillip	Arndt	M
Martin	Arneson	M
Clarence	Arnett	M
Ernest	Arnold	M
Shawn	Aronson	M
Bradley	Arredondo	M
Craig	Arreguin	M
Stanley	Arreola	M
Travis	Arriaga	M
Alyssa	Arrington	F
Josephine	Arriola	F
Shannon	Arrowood	F
Edna	Arroyo	F
Peggy	Arruda	F
Tina	Arsenault	F
Leonard	Arteaga	M
Robin	Arthur	F
Dawn	Artis	F
Earl	Arvizu	M
Sophia	Asbury	F
Jimmy	Ascencio	M
Francis	Ash	M
Rita	Ashby	F
Logan	Ashcraft	M
Wanda	Ashe	F
Todd	Asher	M
Allison	Ashford	F
Danny	Ashley	M
Ethel	Ashmore	F
Cody	Ashton	M
Norma	Ashworth	F
Paula	Askew	F
Dale	Atchison	M
Carlos	Atchley	M
Isabella	Atherton	F
Ella	Atkins	F
Ellen	Atkinson	F
Marjorie	Atwell	F
Clara	Atwood	F
Eleanor	Au	F
Connie	Aubrey	F
Gladys	Aucoin	F
Jamie	August	F
Carrie	Augustin	F
Allen	Augustine	M
Leslie	Ault	F
Edith	Austin	F
Alex	Autry	M
Audrey	Avalos	F
Wendy	Avant	F
Luis	Avelar	M
Frederick	Avery	M
Joel	Avila	M
Curtis	Aviles	M
Courtney	Avina	F
Elaine	Ayala	F
Cindy	Aycock	F
Cameron	Ayers	M
Caleb	Ayres	M
Nathaniel	Azevedo	M
Valerie	Aziz	F
Eva	Babb	F
Norman	Babbitt	M
Tracy	Babcock	F
Esther	Baber	F
Marvin	Babin	M
Vanessa	Baca	F
Glenn	Bach	M
Tony	Bachman	M
Monica	Back	F
Evan	Backus	M
Isaac	Bacon	M
Rodney	Bader	M
Hazel	Badger	F
Melvin	Badillo	M
Brianna	Baer	F
Alfred	Baez	M
Elijah	Baeza	M
Steve	Bagby	M
Chad	Baggett	M
Antonio	Bagley	M
Sheila	Bagwell	F
Sylvia	Bahena	F
Edwin	Bahr	M
Jasmine	Baier	F
April	Bailey	F
Melanie	Bain	F
Katie	Baines	F
Luke	Bair	M
Lee	Baird	M
Sherry	Baker	F
Erica	Balch	F
Jeffery	Balderas	M
Herbert	Balderrama	M
Pauline	Baldridge	F
Mason	Baldwin	M
Thelma	Bales	F
Derek	Ball	M
Alexandra	Ballard	F
Michele	Ballenger	F
Marcus	Ballesteros	M
Alicia	Ballew	F
Theodore	Ballinger	M
Lucille	Ballou	F
Ricky	Baltazar	M
Suzanne	Bancroft	F
Kristen	Banda	F
Jesus	Bandy	M
Veronica	Bane	F
Anita	Banks	F
Adrian	Bankston	M
Caroline	Banner	F
Joanne	Bannister	F
Dolores	Bannon	F
Geraldine	Banta	F
Angel	Banuelos	M
Eddie	Baptiste	M
Lorraine	Barahona	F
Rhonda	Barajas	F
Jill	Baran	F
Bertha	Barba	F
Troy	Barbee	M
Juanita	Barber	F
Ian	Barbieri	M
Hunter	Barbosa	M
Morgan	Barbour	F
Leah	Barboza	F
Mike	Barclay	M
Darlene	Bard	F
Dustin	Barden	M
Sally	Bare	F
Wesley	Barefoot	M
Ava	Barela	F
Lucas	Barfield	M
Gail	Barger	F
Ray	Barham	M
Bernard	Barker	M
Leroy	Barkley	M
Holly	Barksdale	F
Randall	Barley	M
Jared	Barlow	M
Vivian	Barnard	F
Jackson	Barner	M
Oscar	Barnes	M
Calvin	Barnett	M
Dana	Barnette	F
Beatrice	Barney	F
June	Barnhart	F
Marion	Barnhill	F
Debbie	Barnum	F
Clifford	Barnwell	M
Jay	Baron	M
Ida	Barone	F
Isaiah	Barr	M
Eileen	Barragan	F
Shane	Barraza	M
Lucy	Barrera	F
Connor	Barreto	M
Renee	Barrett	F
Brooke	Barrick	F
Leo	Barrientos	M
Lynn	Barringer	F
Bernice	Barrington	F
Chloe	Barrios	F
Ronnie	Barron	M
Barry	Barros	M
Kim	Barrow	F
Manuel	Barrows	M
Corey	Barry	M
Kristin	Barta	F
Jo	Bartel	F
Julian	Bartell	M
Gertrude	Bartels	F
Regina	Barth	F
Madeline	Bartholomew	F
Tommy	Bartlett	M
Elsie	Bartley	F
Loretta	Barton	F
Mia	Bartz	F
Warren	Basham	M
Tara	Basile	F
Rosa	Baskin	F
Jeremiah	Bass	M
Roberta	Bassett	F
Bessie	Bastian	F
Cathy	Batchelder	F
Jayden	Batchelor	M
Dean	Bateman	M
Claire	Bates	F
Annette	Batista	F
Miguel	Batiste	M
Don	Batson	M
Laurie	Battaglia	F
Jessie	Batten	F
Cassandra	Battle	F
Jon	Battles	M
Jeanne	Batts	F
Charlie	Baucom	M
Blake	Bauer	M
Jeanette	Baugh	F
Stacy	Baughman	F
Colleen	Baum	F
Sydney	Bauman	F
Leon	Baumann	M
Mitchell	Baumgardner	M
Bill	Baumgartner	M
Lloyd	Bautista	M
Beth	Baxley	F
Jerome	Baxter	M
Kaitlyn	Bay	F
Minnie	Bayer	F
Darrell	Bayless	M
Aiden	Baylor	M
Alma	Bayne	F
Molly	Bays	F
Agnes	Bazan	F
Gavin	Beach	M
Alvin	Beal	M
Seth	Beale	M
Brett	Beall	M
Chelsea	Beals	F
Joann	Beam	F
Yvonne	Beaman	F
Stella	Bean	F
Lindsey	Beane	F
Pearl	Bear	F
Lillie	Beard	F
Rosemary	Bearden	F
Floyd	Beardsley	M
Lydia	Beasley	F
Vicki	Beason	F
Trevor	Beaton	M
Jim	Beattie	M
Micheal	Beatty	M
Gordon	Beaty	M
Haley	Beauchamp	F
Gina	Beaudoin	F
Lewis	Beaulieu	M
Erik	Beaumont	M
Nellie	Beauregard	F
Savannah	Beaver	F
Owen	Beavers	M
Edgar	Becerra	M
Carla	Bechtel	F
Stacey	Beck	F
Amelia	Becker	F
Georgia	Beckett	F
Devin	Beckham	M
Dominic	Beckley	M
Terri	Beckman	F
Naomi	Beckner	F
Vernon	Beckwith	M
Hailey	Bedard	F
Chase	Bedell	M
Sue	Bedford	F
Maureen	Bedolla	F
Kelsey	Bedwell	F
Chris	Bee	M
Arlene	Beebe	F
Shelby	Beecher	F
Jenna	Beeler	F
Clyde	Beeman	M
Mario	Beer	M
Destiny	Beers	F
Marian	Beeson	F
Heidi	Begay	F
Wilma	Beggs	F
Derrick	Begley	M
Tom	Begum	M
Constance	Behm	F
Max	Behnke	M
Brent	Behrens	M
Marc	Bejarano	M
Liam	Belanger	M
Myrtle	Belcher	F
Vera	Belden	F
Herman	Belk	M
Ricardo	Bell	M
Daisy	Bellamy	F
Melinda	Bellinger	F
Kristina	Bello	F
Carmen	Belt	F
Lena	Belton	F
Sabrina	Beltran	F
Franklin	Bemis	M
Deanna	Benally	F
Marcia	Benavides	F
Maurice	Benavidez	M
Charlene	Bender	F
Mabel	Benedict	F
Paige	Benefield	F
Joy	Benfield	F
Viola	Benge	F
Landon	Benham	M
Mattie	Benitez	F
Tamara	Benjamin	F
Lester	Benn	M
Gabrielle	Benner	F
Marlene	Bennett	F
Lindsay	Benoit	F
Francisco	Benson	M
Gilbert	Bent	M
Katelyn	Bentley	F
Elmer	Benton	M
Nora	Bentz	F
Jennie	Benz	F
Garrett	Berg	M
Gene	Bergen	M
Clayton	Berger	M
Claudia	Bergeron	F
Glen	Berglund	M
Alejandro	Bergman	M
Faith	Bergmann	F
Cory	Bergstrom	M
Jorge	Berkley	M
Lily	Berkowitz	F
Violet	Berlin	F
Nina	Berman	F
Erika	Bermudez	F
Sam	Bernal	M
Cole	Bernard	M
Cora	Bernardo	F
Ivan	Berndt	M
Chester	Berner	M
Tonya	Bernhardt	F
Jeff	Bernier	M
Patsy	Bernstein	F
Wyatt	Berrios	M
Carter	Berry	M
Colin	Berryhill	M
Harvey	Berryman	M
Marissa	Bertram	F
Delores	Bertrand	F
Andre	Berube	M
Priscilla	Bess	F
Jake	Bessette	M
Xavier	Best	M
Milton	Betancourt	M
Tanya	Bethea	F
Grant	Bethel	M
Gwendolyn	Bettencourt	F
Oliver	Bettis	M
Levi	Betts	M
Duane	Betz	M
Mackenzie	Beverly	F
Sebastian	Bevins	M
Kaylee	Bey	F
Angelina	Beyer	F
Yolanda	Bianchi	F
Spencer	Bianco	M
Jimmie	Bias	M
Maxine	Bible	F
Isabel	Bice	F
Carole	Bickel	F
Maggie	Bickford	F
Caitlin	Biddle	F
Vickie	Bidwell	F
Reginald	Bieber	M
Sadie	Bierman	F
Glenda	Bigelow	F
Ruben	Biggers	M
Mae	Biggs	F
Casey	Bigham	M
Alison	Bill	F
Autumn	Billings	F
Alexa	Billingsley	F
Miranda	Bills	F
Leona	Billups	F
Brandy	Bilodeau	F
Margie	Binder	F
Cecil	Bingham	M
Genevieve	Binkley	F
Dan	Birch	M
Roberto	Bird	M
Dora	Birdsong	F
Zoe	Birdwell	F
Miriam	Birmingham	F
Preston	Bischoff	M
Marsha	Bishop	F
Bryce	Bissell	M
Arnold	Bittner	M
Sophie	Bivens	F
Aidan	Bivins	M
Lance	Bixler	M
Mariah	Black	F
Brandi	Blackburn	F
Johnnie	Blackford	M
Billie	Blackman	F
Neil	Blackmon	M
Gabriella	Blackwell	F
Darren	Blackwood	M
Katrina	Blades	F
Karl	Blain	M
Colton	Blaine	M
Sofia	Blair	F
Joanna	Blais	F
Toni	Blake	F
Eduardo	Blakely	M
Hector	Blakley	M
Kay	Blalock	F
Tristan	Blanchard	M
Christy	Blanchette	F
Jocelyn	Blanco	F
Addison	Bland	F
Hattie	Blank	F
Kylie	Blankenship	F
Kara	Blanks	F
Brayden	Blanton	M
Penny	Blaylock	F
Clinton	Bledsoe	M
Ana	Blessing	F
Roland	Blevins	M
Makayla	Bliss	F
Dianne	Blizzard	F
Bethany	Bloch	F
Whitney	Block	F
Diego	Blocker	M
Eli	Blodgett	M
Natasha	Blood	F
Meghan	Bloodworth	F
Sierra	Bloom	F
Lonnie	Bloomer	M
Alexandria	Bloomfield	F
Allan	Blount	M
Marguerite	Blue	F
Everett	Blum	M
Bob	Blume	M
Kendra	Blunt	F
Fernando	Bly	M
Ada	Blythe	F
Avery	Boardman	F
Javier	Boatman	M
Darryl	Boatright	M
Claude	Boatwright	M
Felicia	Bobbitt	F
Briana	Bobo	F
Jackie	Bocanegra	F
Omar	Bock	M
Jenny	Bode	F
Cecilia	Bodine	F
Johnathan	Bodnar	M
Guy	Boehm	M
Bailey	Boettcher	F
Hayden	Bogan	M
Carson	Bogart	M
Bobbie	Boger	F
Harriet	Boggess	F
Melody	Boggs	F
Bridget	Bogle	F
Riley	Bohannon	M
Marshall	Bohn	M
Blanche	Boisvert	F
Angelica	Bojorquez	F
Brendan	Boland	M
Geneva	Bolanos	F
Velma	Bolden	F
Karla	Boldt	F
Becky	Bolduc	F
Aubrey	Bolen	F
Tracey	Boles	F
Tanner	Boley	M
Parker	Bolin	M
Pedro	Boling	M
Andy	Bolinger	M
Kurt	Bolling	M
Fannie	Bollinger	F
Susie	Bolt	F
Misty	Bolton	F
Candace	Bond	F
Shelly	Bonds	F
Lula	Bone	F
Jacquelyn	Bonham	F
Kristine	Bonilla	F
Sherri	Bonnell	F
Hope	Bonner	F
Adriana	Bonney	F
Lola	Bontrager	F
Tim	Booher	M
Ariana	Book	F
Brad	Booker	M
Sidney	Boone	M
Dakota	Booth	M
Raul	Boothe	M
Brady	Bordelon	M
Ben	Borden	M
Brittney	Borders	F
Rachael	Boren	F
Abraham	Borg	M
Rick	Borges	M
Isabelle	Boring	F
Desiree	Borja	F
Wallace	Borkowski	M
Hilda	Born	F
Hugh	Borrego	M
Ross	Bosch	M
Breanna	Bosco	F
Brooklyn	Bosley	F
Maxwell	Boss	M
Josiah	Bost	M
Nicolas	Bostic	M
Maya	Bostick	F
Jillian	Boston	F
Jodi	Bostwick	F
Eunice	Boswell	F
Byron	Bosworth	M
Sheryl	Botelho	F
Micah	Botello	M
Rosie	Bott	F
Monique	Bottoms	F
Antoinette	Botts	F
Dwight	Bouchard	M
Mamie	Boucher	F
Lynda	Boudreau	F
Tyrone	Boudreaux	M
Greg	Bounds	M
Dalton	Bourgeois	M
Nolan	Bourne	M
Willard	Bourque	M
Andres	Boutwell	M
Arianna	Bowden	F
Kristi	Bowe	F
Kate	Bowen	F
Nelson	Bowens	M
Madelyn	Bower	F
Dwayne	Bowers	M
Ted	Bowes	M
Kelli	Bowie	F
Gabriela	Bowler	F
Perry	Bowles	M
Iris	Bowlin	F
Julius	Bowling	M
Angelo	Bowman	M
Janie	Bowser	F
Ramon	Box	M
Rafael	Boyce	M
Krystal	Boyd	F
Mathew	Boyer	M
Irma	Boyett	F
Beulah	Boyette	F
Krista	Boykin	F
Damian	Boylan	M
Jade	Boyle	F
Shelley	Boyles	F
Freddie	Boynton	M
Collin	Bozeman	M
Sergio	Brace	M
Drew	Bracey	M
Summer	Bracken	F
Meredith	Brackett	F
Rebekah	Bradbury	F
Belinda	Braddock	F
Virgil	Braden	M
Terrence	Bradford	M
Alberta	Bradley	F
Kristy	Bradshaw	F
Armando	Brady	M
Morris	Bragg	M
Aaliyah	Brake	F
Bianca	Bramlett	F
Trinity	Brammer	F
Clifton	Branch	M
Jeannette	Brand	F
Devon	Brandenburg	M
Verna	Brandon	F
Shaun	Brandt	M
Opal	Branham	F
Sandy	Brannan	F
Stuart	Brannon	M
Cesar	Branson	M
Kent	Brant	M
Kaleb	Brantley	M
Gracie	Brashear	F
Terrance	Brasher	M
Rosalie	Braswell	F
Flora	Bratcher	F
Kirk	Bratton	M
Candice	Brauer	F
Ramona	Braun	F
Inez	Bravo	F
Jaden	Braxton	M
Faye	Bray	F
Miles	Brazil	M
Della	Breaux	F
Marco	Breckenridge	M
Wade	Breeden	M
Erick	Breeding	M
Cooper	Breedlove	M
Adrienne	Breen	F
Luther	Brehm	M
Jaime	Breland	M
Emmanuel	Bremer	M
Nevaeh	Brennan	F
Cheyenne	Brenneman	F
Sonya	Brenner	F
Marianne	Brent	F
Sonia	Breslin	F
Felix	Brett	M
Elena	Brewer	F
Jonathon	Brewington	M
Dave	Brewster	M
Guadalupe	Brian	F
Harrison	Brice	M
Fredrick	Bricker	M
Marcella	Bridge	F
Nichole	Bridges	F
Yvette	Briggs	F
Patty	Brigham	F
Elias	Bright	M
Layla	Briley	F
Daryl	Brill	M
Camille	Brink	F
Lynne	Brinker	F
Maryann	Brinkley	F
Ariel	Brinkman	F
Gayle	Brinson	F
Jada	Briones	F
Olga	Briscoe	F
Damon	Briseno	M
Robyn	Brister	F
Rickey	Bristol	M
Angie	Bristow	F
Carly	Brito	F
Homer	Britt	M
Lila	Brittain	F
Dillon	Britton	M
Sheri	Broadnax	F
Kristopher	Broadway	M
Donnie	Brock	M
Dominick	Brockman	M
Ashton	Brockway	M
Elise	Broderick	F
Valeria	Brodie	F
Malcolm	Brody	M
Peyton	Brogan	F
Kari	Brogdon	F
Alberto	Bromley	M
Earnest	Bronson	M
Lorenzo	Brook	M
Myra	Brooke	F
Cristian	Brooker	M
Julio	Brookins	M
Zoey	Brooks	F
Roxanne	Brookshire	F
Gerard	Broom	M
Hubert	Broome	M
Giovanni	Brophy	M
Otis	Brothers	M
Tabitha	Brotherton	F
Lyle	Broughton	M
Kaitlin	Broussard	F
Brody	Browder	M
Wilbur	Brower	M
Dallas	Brown	M
Rex	Browne	M
Karina	Brownell	F
Ayden	Browning	M
Jody	Brownlee	F
Abby	Broyles	F
Dianna	Brubaker	F
Natalia	Bruce	F
Celeste	Brumbaugh	F
Erma	Brumfield	F
Enrique	Brumley	M
Israel	Brummett	M
Jonah	Brundage	M
Muriel	Brunelle	F
Salvatore	Bruner	M
Jan	Brunner	F
Alisha	Bruno	F
Cecelia	Bruns	F
Kennedy	Brunson	F
Simon	Brush	M
Gianna	Bruton	F
Horace	Bryan	M
Neal	Bryant	M
Geoffrey	Bryce	M
Daniela	Bryson	F
Rudolph	Bucci	M
Caden	Buchanan	M
Bernadette	Bucher	F
Vicky	Buchholz	F
Trenton	Buck	M
Celia	Buckingham	F
Wendell	Buckles	M
Gretchen	Buckley	F
Gage	Buckman	M
Mable	Buckner	F
Kendall	Budd	F
Alfredo	Buehler	M
Josie	Buell	F
Kaden	Bueno	M
Ira	Buenrostro	M
Aimee	Buffington	F
Roman	Buford	M
Kirsten	Bui	F
Estelle	Buie	F
Bennie	Bull	M
Traci	Bullard	F
Donovan	Bullock	M
Callie	Bulwer-Lytton	F
Mallory	Bumgarner	F
Cassidy	Bunce	F
Arturo	Bunch	M
Nadine	Bundy	F
Willis	Bunker	M
Lora	Bunn	F
Damien	Bunnell	M
Janelle	Bunting	F
Mckenzie	Burbank	F
Genesis	Burch	F
Alana	Burcham	F
Leonardo	Burchett	M
Olive	Burchfield	F
Joey	Burd	M
Caitlyn	Burden	F
Henrietta	Burdette	F
Kellie	Burdick	F
Cara	Burford	F
Cristina	Burg	F
Leland	Burge	M
Juliana	Burger	F
Alec	Burgess	M
Edmund	Burgett	M
Rosemarie	Burgin	F
Mikayla	Burgos	F
Archie	Burk	M
Kenny	Burke	M
Sallie	Burkett	F
Dominique	Burkhalter	F
Kerry	Burkhardt	M
Nettie	Burkhart	F
Lilly	Burkholder	F
Johanna	Burks	F
Randolph	Burleson	M
Gerardo	Burley	M
Nick	Burmeister	M
Lacey	Burnett	F
Darius	Burnette	M
Annabelle	Burney	F
Janis	Burnham	F
Trent	Burns	M
Colby	Burnside	M
Kelvin	Burr	M
Allyson	Burrell	F
Lana	Burress	F
Jaclyn	Burris	F
Rene	Burroughs	M
Conner	Burrow	M
Bryant	Burrows	M
Carlton	Burson	M
Marisa	Burt	F
Betsy	Burton	F
Michaela	Burwell	F
May	Busby	F
Shelia	Busch	F
Alejandra	Bush	F
Raquel	Bushey	F
Garry	Bushman	M
Mya	Bushnell	F
Jace	Buss	M
Skylar	Busse	F
Hayley	Bussey	F
Eula	Bustamante	F
Jaxon	Bustillos	M
Rudy	Bustos	M
Emanuel	Butcher	M
Bryson	Butler	M
Delbert	Butt	M
Forrest	Butterfield	M
Corinne	Butterworth	F
Rochelle	Button	F
Eloise	Butts	F
Benny	Butz	M
Marcos	Buxton	M
Doreen	Byars	F
Alton	Bybee	M
Selena	Byerly	F
Grayson	Byers	M
Kelley	Byler	F
Lottie	Bynum	F
Loren	Byrd	M
Roderick	Byrne	M
Paulette	Byrnes	F
Eliza	Byron	F
Santiago	Byrum	M
Christie	Caballero	F
Mollie	Caban	F
Ginger	Cable	F
Orlando	Cabral	M
Maude	Cabrera	F
Payton	Caceres	F
Latoya	Cade	F
Salvador	Cadena	M
Bella	Cady	F
Shawna	Cage	F
Kiara	Cagle	F
Jordyn	Cahill	F
Adeline	Cahoon	F
Liliana	Cai	F
Mona	Cain	F
Patti	Cairns	F
Cassie	Calabrese	F
Elisabeth	Calder	F
Camila	Caldera	F
Allie	Calderon	F
Wilson	Caldwell	M
Ellie	Calhoun	F
Myron	Calkins	M
Ernestine	Call	F
Mercedes	Callaghan	F
Teri	Callahan	F
Noel	Callan	M
Jana	Callaway	F
Will	Callender	M
Josue	Calloway	M
Effie	Calvert	F
Grady	Calvillo	M
Addie	Calvin	F
Kylee	Calvo	F
Irving	Camacho	M
Ty	Camara	M
Pete	Camarena	M
Lorena	Camargo	F
Ashlee	Camarillo	F
Laverne	Cameron	F
Emmett	Camp	M
Tessa	Campa	F
Jasmin	Campagna	F
Winifred	Campbell	F
Lynette	Campbell-Bannerman	F
Sylvester	Campo	M
Laurel	Campos	F
Freda	Canada	F
Esmeralda	Canady	F
Ashlyn	Canales	F
Serenity	Candelaria	F
Chance	Canfield	M
Dixie	Cannady	F
Braden	Cannon	M
Sammy	Cano	M
Clark	Canter	M
Mandy	Canterbury	F
Lela	Cantrell	F
Pablo	Cantu	M
Mindy	Cantwell	F
Darla	Canty	F
Leticia	Cao	F
Adrianna	Capers	F
Ernesto	Capone	M
Meagan	Capps	F
Abel	Caputo	M
Lowell	Caraballo	M
Shari	Caraway	F
Leila	Carbajal	F
Ollie	Carbone	F
Katharine	Card	F
Alexia	Carden	F
Malik	Cardenas	M
Etta	Carder	F
Pat	Cardinal	F
Penelope	Cardona	F
Elisa	Cardoso	F
Reagan	Cardoza	F
Tricia	Cardwell	F
Aurora	Carey	F
Rylee	Cargill	F
Carolina	Carl	F
Frankie	Carley	M
Zane	Carlile	M
Jermaine	Carlin	M
Wilbert	Carlisle	M
Leigh	Carlos	F
Dante	Carlsen	M
Cedric	Carlson	M
Trisha	Carlton	F
Alonzo	Carmack	M
Junior	Carman	M
Nikki	Carmichael	F
Essie	Carmody	F
Lorene	Carmona	F
Laurence	Carnahan	M
Ivy	Carnes	F
Margarita	Carney	F
Stacie	Caro	F
Julianna	Caron	F
Ora	Carothers	F
Irvin	Carpenter	M
Sherman	Carper	M
Jewel	Carpio	F
Jazmin	Carr	F
Sonja	Carranza	F
Alfonso	Carrasco	M
Giselle	Carrasquillo	F
Harper	Carrell	F
Tyson	Carreno	M
Brock	Carreon	M
Ebony	Carrera	F
Lizzie	Carrico	F
Serena	Carrier	F
Nadia	Carrigan	F
Ellis	Carrillo	M
Adele	Carrington	F
Bettie	Carrion	F
Quentin	Carrizales	M
Rena	Carroll	F
Kristie	Carruthers	F
Malachi	Carson	M
Woodrow	Carswell	M
Estella	Cartagena	F
Marla	Carter	F
Yesenia	Cartwright	F
Tami	Carty	F
Elliott	Caruso	M
Ervin	Carvajal	M
Kimberley	Carvalho	F
Bonita	Carver	F
Anastasia	Cary	F
Justine	Casale	F
Harley	Casanova	M
Saul	Casarez	M
Roosevelt	Casas	M
Iva	Case	F
Nickolas	Casey	M
Lucia	Cash	F
Mack	Cashman	M
Clarissa	Casillas	F
Lucinda	Caskey	F
August	Cason	M
Kerri	Casper	F
Stefanie	Cass	F
Alissa	Cassady	F
Raven	Cassel	F
Madeleine	Cassell	F
Moses	Cassidy	M
Scarlett	Castaneda	F
Gregg	Castano	M
Kyla	Castanon	F
Fern	Casteel	F
Hudson	Castellano	M
Cheri	Castellanos	F
Skyler	Castellon	M
Ron	Castillo	M
Fabian	Castle	M
Trey	Castle-Hughes	M
Jeannie	Castleberry	F
Rufus	Casto	M
Goldie	Castor	F
Hanna	Castro	F
Sheldon	Caswell	M
Francine	Catalan	F
Clay	Catalano	M
Delia	Cataldo	F
Braxton	Cate	M
Carroll	Cates	M
Tammie	Cathcart	F
Tasha	Cathey	F
Makenzie	Catlett	F
Gustavo	Catlin	M
Cornelius	Cato	M
Reba	Caton	F
Graham	Catron	M
Lincoln	Caudill	M
Sherrie	Caudle	F
Alondra	Cauley	F
Orville	Causey	M
Therese	Cavanaugh	F
Emilio	Cavazos	M
Melba	Cave	F
Bette	Cavender	F
Angeline	Cawley	F
Deloris	Cazares	F
Jalen	Ceballos	M
Marina	Cecil	F
Lucile	Cedeno	F
Terrell	Cedillo	M
Myles	Ceja	M
Jayla	Centeno	F
Ronda	Cepeda	F
Jasper	Cerda	M
Dewey	Cervantes	M
Lenora	Cha	F
Tori	Chacon	F
Tommie	Chadwick	M
Britney	Chaffee	F
Patrice	Chaffin	F
Silas	Chairez	M
Charity	Chalmers	F
Kayden	Chamberlain	M
Jazmine	Chamberlin	F
Lesley	Chambers	F
Dorothea	Chambliss	F
Alaina	Champagne	F
Lou	Champion	F
Terence	Chan	M
Ina	Chance	F
Bert	Chandler	M
Elbert	Chaney	M
Rachelle	Chang	F
Conrad	Chao	M
Griffin	Chapa	M
Elliot	Chaparro	M
Lane	Chapin	M
Janine	Chaplin	F
Pam	Chapman	F
Helena	Chappell	F
Kyra	Charbonneau	F
Demetrius	Charles	M
Helene	Charlton	F
Aileen	Chartier	F
Ismael	Chase	M
Sasha	Chastain	F
Mariana	Chatman	F
Daphne	Chau	F
Tracie	Chavarria	F
Alisa	Chaves	F
Tucker	Chavez	M
Asher	Chavira	M
Christa	Chavis	F
Ken	Cheatham	M
Trina	Chee	F
Ciara	Cheek	F
Mckenna	Chen	F
Weston	Cheney	M
Toby	Cheng	M
Camden	Chenoweth	M
Tia	Cherry	F
Dena	Cherry-Garrard	F
Darin	Chesney	M
Rodolfo	Chesser	M
Amos	Chester	M
Lamar	Chestnut	M
Tatiana	Cheung	F
Kira	Chevalier	F
Keri	Chew	F
Teddy	Chi	M
Diamond	Chiang	F
Antonia	Child	F
Janette	Childers	F
Ezra	Childress	M
Delaney	Childs	F
Marty	Chiles	M
Fay	Chilton	F
Mayra	Chin	F
Clint	Ching	M
Myrna	Chinn	F
Marisol	Chipman	F
Bradford	Chisholm	M
Kasey	Chism	F
Aliyah	Chitwood	F
Emil	Chiu	M
Ashleigh	Cho	F
Percy	Choate	M
Elva	Choe	F
Chandler	Choi	M
Drake	Chong	M
Stewart	Chou	M
Chelsey	Chow	F
Kassandra	Chowdhury	F
Dexter	Choy	M
Asia	Chrisman	F
Piper	Christ	F
Ryder	Christensen	M
Jamal	Christenson	M
Merle	Christian	M
Doyle	Christiansen	M
Dane	Christianson	M
Otto	Christie	M
Latasha	Christman	F
Blaine	Christmas	M
Ezekiel	Christopher	M
Dina	Christopherson	F
Cleo	Christy	F
Desmond	Chu	M
Dawson	Chun	M
Keegan	Chung	M
Cherie	Church	F
Cathleen	Churchill	F
Lea	Cimino	F
Jayson	Cintron	M
Jolene	Cisneros	F
Matilda	Claiborne	F
Jaylen	Clair	M
Luella	Clancy	F
Bret	Clanton	M
Darrel	Clapp	M
Ola	Clapper	F
Eugenia	Clare	F
Corbin	Clark	M
Brennan	Clarke	M
Bennett	Clarkson	M
Zackary	Clary	M
Phoebe	Claudio	F
Shana	Clausen	F
Solomon	Clawson	M
Dick	Claxton	M
Hugo	Clay	M
Debora	Claypool	F
Jewell	Clayton	F
Wilfred	Cleary	M
Reuben	Cleaver	M
Darrin	Clegg	M
Zachery	Clem	M
Noelle	Clemens	F
Khloe	Clement	F
Easton	Clemente	M
Randi	Clements	F
Polly	Clemmons	F
Randal	Clemons	M
Sterling	Cleveland	M
Katelynn	Clevenger	F
Gwen	Click	F
Lionel	Clifford	M
Shayla	Clift	F
Felipe	Clifton	M
Julianne	Cline	F
Guillermo	Clinton	M
Bentley	Close	M
Leanne	Cloud	F
Alta	Clough	F
Laila	Clouse	F
Jakob	Cloutier	M
Delilah	Coakley	F
Fatima	Coates	F
Quinn	Coats	M
Beau	Cobb	M
Jayne	Cobbs	F
Karin	Coble	F
Marlon	Coburn	M
Hallie	Cochran	F
Hillary	Cochrane	F
Shanna	Cockerham	F
Lorna	Cockrell	F
Candy	Cody	F
Savanna	Coe	F
Joni	Coelho	F
Clare	Coen	F
Leola	Cofer	F
Shauna	Coffee	F
Reid	Coffey	M
Esteban	Coffin	M
Sawyer	Coffman	M
Mateo	Cofield	M
Rosetta	Coggins	F
Carissa	Cohen	F
Darnell	Cohn	M
Quinton	Coker	M
Tania	Colbert	F
Brenna	Colburn	F
Louie	Colby	M
Imogene	Cole	F
Kameron	Coleman	M
London	Coles	F
Kayleigh	Coley	F
Reed	Colin	M
Kai	Collado	M
Macy	Collazo	F
Gilberto	Collett	M
Sondra	Collette	F
Jodie	Colley	F
Cayden	Collier	M
Jude	Collins	M
Cierra	Colombo	F
Millie	Colon	F
Aubree	Colson	F
Elsa	Colton	F
Lukas	Colvin	M
Axel	Colwell	M
Grover	Combs	M
Heath	Comeau	M
Angelique	Comeaux	F
Alyson	Comer	F
Tomas	Compton	M
Van	Comstock	M
Francesca	Conant	F
Boyd	Conard	M
Mickey	Conaway	M
Branden	Concepcion	M
Nell	Conde	F
Elvira	Condon	F
Davis	Cone	M
Haylee	Coney	F
Stephan	Conger	M
Deandre	Conklin	M
Ed	Conley	M
Jaxson	Conlin	M
Selma	Conlon	F
Eden	Conn	F
Susanne	Connell	F
Eliana	Connelly	F
Lara	Conner	F
Jerald	Conners	M
Dewayne	Connolly	M
Antoine	Connor	M
Kendrick	Connors	M
Kaiden	Conover	M
Nannie	Conrad	F
Kyler	Conroy	M
Glenna	Constantine	F
Rocky	Constantino	M
Royce	Conte	M
Rhoda	Conti	F
Timmy	Contreras	M
Staci	Converse	F
Eldon	Conway	M
Trudy	Conyers	F
Jenifer	Cook	F
Rosalind	Cooke	F
Reese	Cooks	F
Keira	Cooksey	F
Brooklynn	Cool	F
Daniella	Cooley	F
Freddy	Coombs	M
Frieda	Coomer	F
Clarice	Coon	F
Ingrid	Cooney	F
Jarrod	Coons	M
Rocco	Cooper	M
Jess	Cope	M
Moises	Copeland	M
Juliet	Copley	F
Luz	Coppola	F
Tiana	Corbett	F
Makenna	Corbin	F
Athena	Corbitt	F
Zachariah	Corcoran	M
Valentina	Cordell	F
Joaquin	Corder	M
Winston	Cordero	M
Paris	Cordes	F
Johnathon	Cordova	M
Vance	Corey	M
Blanca	Corley	F
Willa	Cormier	F
Brenden	Corn	M
Alina	Cornejo	F
Taryn	Cornelius	F
Leilani	Cornell	F
Cary	Cornett	M
Emilie	Cornish	F
Edmond	Cornwell	M
Audra	Corona	F
Jeannine	Coronado	F
Cade	Coronel	M
Simone	Corral	F
Adan	Corrales	M
Hilary	Correa	F
Leann	Correa-McMullen	F
Ramiro	Correia	M
Jaiden	Correll	M
Garland	Corrigan	M
Darwin	Corso	M
Jeanine	Corson	F
Amaya	Cortes	F
Chasity	Cortez	F
Kailey	Corwin	F
Aria	Cory	F
Rogelio	Cosby	M
Bobbi	Cosentino	F
Maribel	Cosgrove	F
Greta	Costa	F
Matt	Costanzo	M
Rory	Costello	M
Lizbeth	Coston	F
Deana	Cota	F
Kenya	Cote	F
Lamont	Cotten	M
Emilia	Cotter	F
Kiana	Cottle	F
Isiah	Cotto	M
Charley	Cotton	M
Margo	Cottrell	F
Quincy	Couch	M
Bettye	Coughlin	F
Carmela	Coulson	F
Winnie	Coulter	F
Bridgette	Council	F
Tiara	Counts	F
Ericka	Courtney	F
Camryn	Cousins	F
Rylan	Couture	M
Amir	Covarrubias	M
Tamika	Covert	F
Marquis	Covey	M
Harlan	Covington	M
Ali	Cowan	M
Eve	Coward	F
Jeri	Cowart	F
Rolando	Cowell	M
Doug	Cowen	M
Adelaide	Cowles	F
Thaddeus	Cowley	M
Leanna	Cox	F
Talia	Coy	F
Loyd	Coyle	M
Brielle	Coyne	F
Anderson	Cozart	M
Buddy	Crabb	M
Robbie	Crabtree	F
Burton	Craddock	M
Lenore	Craft	F
Sheena	Craig	F
Alivia	Crain	F
Tonia	Cramer	F
Anton	Crandall	M
Alayna	Crane	F
Angelia	Cranford	F
Heaven	Craven	F
Bernadine	Cravens	F
Julissa	Crawford	F
Maritza	Crawley	F
Monte	Crayton	M
Lorie	Creamer	F
Flossie	Creech	F
Virgie	Creed	F
Larissa	Creel	F
Jarrett	Creighton	M
Keisha	Crenshaw	F
Evangeline	Crespo	F
Cleveland	Cress	M
Latonya	Crews	F
Cornelia	Cribbs	F
Juliette	Crider	F
Nola	Crim	F
Ila	Crisp	F
Lyla	Criss	F
Harriett	Crist	F
Jonas	Criswell	M
Marcy	Crites	F
Rodrigo	Crittenden	M
Elma	Crocker	F
Murray	Crockett	M
Paola	Croft	F
Roscoe	Cromer	M
Rae	Cromwell	F
Jami	Crone	F
Rodger	Cronin	M
Arielle	Cronk	F
Imani	Crook	F
Declan	Crooks	M
India	Croom	F
Fiona	Crosby	F
Maddox	Cross	M
Ladonna	Crossley	F
Emilee	Crossman	F
Amie	Croteau	F
Elnora	Crouch	F
Kody	Crouse	M
Darcy	Crow	F
Landen	Crowder	M
Jameson	Crowe	M
Abbie	Crowell	F
Zion	Crowley	M
Johnie	Crozier	M
Christi	Crum	F
Erwin	Crump	M
Malinda	Crumpton	F
Sammie	Cruse	M
Izabella	Crutcher	F
Elton	Crutchfield	M
Ashlynn	Cruz	F
Jefferson	Cuellar	M
Walker	Cuevas	M
Colette	Culbertson	F
Neva	Cullen	F
Corrine	Cullum	F
Aniyah	Culp	F
Marlin	Culpepper	M
Norbert	Culver	M
Ruthie	Cummings	F
Dorthy	Cummins	F
Elwood	Cundiff	M
Cecile	Cunha	F
Rosalyn	Cunningham	F
Issac	Cupp	M
Nelda	Curcio	F
Kali	Cureton	F
Brianne	Curiel	F
Brooks	Curl	M
Susana	Curley	F
Sienna	Curran	F
Phil	Currie	M
Gale	Currier	F
Elinor	Curry	F
Katy	Curtin	F
Noreen	Curtis	F
Conor	Curtiss	M
Dolly	Cushing	F
Terrie	Cushman	F
Elvin	Cusick	M
Alanna	Custer	F
Denis	Cutler	M
Noe	Cutter	M
Emerson	Cyr	M
Aisha	Cyrus	F
Silvia	Czarnecki	F
Harmony	DaSilva	F
Mauricio	Dabbs	M
Tabatha	Dabney	F
Lacy	Dacosta	F
Madalyn	Dae-Jung	F
Lexi	Daggett	F
Vaughn	Dagostino	M
Brynn	Dahl	F
Elaina	Daigle	F
Reynaldo	Dailey	M
Dollie	Daily	F
Cruz	Dale	M
Letha	Dalessandro	F
Nia	Daley	F
Camilla	Dallas	F
Brendon	Dalrymple	M
Nikolas	Dalton	M
Sybil	Daly	F
Tanisha	Damato	F
Karissa	Damian	F
Cyrus	Damico	M
Carmella	Damon	F
Mara	Damron	F
Dona	Dana	F
Malia	Dancy	F
Marley	Dandrea	F
Mavis	Danforth	F
Adolph	Dang	M
Yasmin	Dangelo	F
Claudette	Daniel	F
Kaylie	Daniels	F
Duncan	Danielson	M
Noemi	Danley	F
Xander	Danner	M
Viviana	Dao	F
Lupe	Darby	F
Maura	Darcy	F
Kiera	Darden	F
Tristen	Darling	M
Melisa	Darnell	F
Scotty	Darr	M
Precious	Darrow	F
Stefan	Das	M
Dorian	Daugherty	M
Latisha	Daughtry	F
Alexus	Davalos	F
Valarie	Davenport	F
Katlyn	Davey	F
Paisley	David	F
Derick	Davidson	M
Gus	Davies	M
Hadley	Davila	F
Annmarie	Davis	F
Pearlie	Davison	F
Willow	Dawes	F
Susanna	Dawkins	F
Kelsie	Dawson	F
Esperanza	Day	F
Nathanael	Day-Lewis	M
Gay	Dayton	F
Lauryn	DeAnda	F
Roxie	DeAngelo	F
Perla	DeBergh	F
Bryanna	DeBerry	F
Vicente	DeBoer	M
Saundra	DeBostock	F
Louisa	DeBourge	F
Chuck	DeCastro	M
Kiley	DeCay	F
Kristian	DeCoppens	M
Mila	DeFamio	F
Hollie	DeFluri	F
Maximus	DeFraia	M
Ilene	DeFrange	F
Ryleigh	DeFree	F
Arline	DeGear	F
Aron	DeGnath	M
Raphael	DeGuaincour	M
Eleanore	DeHart	F
Kurtis	DeHaven	M
Keaton	DeLespine	M
Nathalie	DeLong	F
Rusty	DeLuca	M
Kimberlee	DeMarco	F
Greyson	DeMarmein	M
Kamryn	DeMonge	F
Ignacio	DeMoss	M
Odessa	DePalma	F
Lorrie	DePauli	F
Holden	DePerno	M
Chandra	DePoty	F
Araceli	DeRatt	F
Ned	DeRosa	M
Jayce	DeSaegher	M
Pierre	DeSalme	M
Selina	DeSimencourt	F
Juana	DeSimone	F
Avis	DeStefano	F
Elyse	DeTurck	F
Loraine	DeVaughan	F
Tatum	DeVito	F
Beatriz	DeVoir	F
Zackery	DeVore	M
Jeanie	DeVries	F
Alyce	DeWilfond	F
Dion	DeWinne	M
Milo	DeWitt	M
Al	DeYarmett	M
Baylee	DeYoung	F
Danna	Deal	F
Efrain	Dean	M
Cortney	Deane	F
Sharron	Deangelis	F
Luca	Dearing	M
Nanette	Deason	F
Emery	Deaton	M
Aden	Deaver	M
Consuelo	Decarlo	F
Martina	Deck	F
Ulysses	Deckard	M
Abbey	Decker	F
Marta	Dee	F
Roslyn	Deel	F
Cadence	Deering	F
Carey	Dees	M
Zelma	Deese	F
Millard	Degroot	M
Emiliano	Deguzman	M
Magdalena	Dejesus	F
Deirdre	Dejong	F
Wiley	DelAmarre	M
Leonel	DelGado	M
Jarvis	Delacruz	M
Kaylin	Delafuente	F
Curt	Delagarza	M
Jayda	Delaney	F
Suzette	Delano	F
Earline	Delao	F
Mikaela	Delapaz	F
Hal	Delarosa	M
Nona	Delatorre	F
Emely	Deleon	F
Lavonne	Delgadillo	F
Kermit	Delia	M
Paulina	Delk	F
Macie	Dell	F
Kassidy	Dellinger	F
Russel	Deloach	M
Bart	Delossantos	M
Marcel	Delp	M
Dulce	Delrio	F
Thurman	Delrosario	M
Ernie	Deltoro	M
Liza	Deluna	F
Skye	Delvalle	F
Althea	Delvecchio	F
Elissa	Demers	F
Elvis	Deming	M
Norris	Dempsey	M
Belle	Denham	F
Rickie	Denis	M
Josh	Denison	M
Jacklyn	Denman	F
Augusta	Denney	F
Earnestine	Denning	F
Barney	Dennis	M
Cathryn	Dennison	F
Reece	Denny	M
Galen	Denson	M
Ophelia	Dent	F
Santos	Denton	M
Coy	Depew	M
Romeo	Derby	M
Janae	Derr	F
Keenan	Derrick	M
Emory	Derry	M
Kyleigh	DesPlanques	F
Dee	DesVoigne	F
Irwin	Desai	M
Nicolette	Desantiago	F
Humberto	Desantis	M
Margery	Desmond	F
Ximena	Desouza	F
Brandie	Desrosiers	F
Roseann	Detwiler	F
Maddison	Deutsch	F
Sonny	Devaney	M
King	Dever	M
Annika	Devine	F
Chrystal	Devlin	F
Nayeli	Devoe	F
Casandra	Dew	F
Damion	Deweese	M
Presley	Dewey	F
Carley	Dexter	F
Kathrine	DiBenedetto	F
Monroe	DiClemento	M
Zander	DiFrisco	M
Chanel	DiGraziano	F
Destinee	DiStefano	F
Javon	Dial	M
Coleman	Diamond	M
Ahmad	Dias	M
Joesph	Diaz	M
Justice	Dibble	M
Joselyn	Dick	F
Libby	Dickens	F
Jerri	Dickenson	F
Luann	Dickerson	F
Edwina	Dickey	F
Titus	Dickinson	M
Janell	Dickman	F
Deja	Dicks	F
Reva	Dickson	F
Gael	Diehl	M
Lelia	Diep	F
Gillian	Dietrich	F
Shayna	Dietz	F
Rosella	Diggs	F
Marcie	Digiovanni	F
Kaitlynn	Dill	F
Charmaine	Dillard	F
Corina	Dilley	F
Mari	Dillingham	F
Janna	Dillman	F
Tobias	Dillon	M
Cristal	Dilworth	F
Jeffry	Dimas	M
Rhea	Dingman	F
Lia	Dinh	F
Graciela	Dinkins	F
Tate	Dinsmore	M
Sarai	Dion	F
Carlene	Dionne	F
Denny	Dipietro	M
Kathie	Dirks	F
Adolfo	Dishman	M
Lynnette	Dix	F
Minerva	Dixon	F
Georgina	Dizon	F
Alphonso	Do	M
Armand	DoBoto	M
Luna	Doan	F
Khalil	Doane	M
Kierra	Dobbins	F
Sanford	Dobbs	M
Wilmer	Dobson	M
Alessandra	Dockery	F
Catalina	Dodd	F
Octavia	Dodds	F
Deanne	Dodge	F
Ester	Dodson	F
Tiffani	Doe	F
Kaleigh	Doering	F
Marianna	Doerr	F
Maynard	Doggett	M
Jannie	Doherty	F
Melina	Dolan	F
Regan	Doll	F
Lina	Dollar	F
Forest	Dombrowski	M
Chantel	Domingo	F
Lilian	Dominguez	F
Shania	Dominick	F
Marietta	DonSang	F
Bruno	Donahue	M
Tyrell	Donald	M
Rosanne	Donaldson	F
Monty	Donato	M
Deidre	Dong	F
Katheryn	Donley	F
Asa	Donnell	M
Kingston	Donnelly	M
Odell	Donner	M
Jamison	Donofrio	M
Ward	Donohue	M
Tierra	Donovan	F
Rosalinda	Dooley	F
Jaqueline	Doolittle	F
Aldo	Doran	M
Ayla	Dore	F
Rashad	Dorman	M
Donte	Dorn	M
Terra	Dorr	F
Aniya	Dorris	F
Corine	Dorsett	F
Nyla	Dorsey	F
Jamar	Dortch	M
Brice	Doss	M
Wendi	Dotson	F
Ursula	Doty	F
Sage	Doucet	F
Bryon	Doucette	M
Norah	Dougherty	F
Merlin	Doughty	M
Uriel	Douglas	M
Rylie	Douglass	F
Tillie	Dove	F
Harris	Dover	M
Cheyanne	Dow	F
Carina	Dowd	F
Gerry	Dowdell	M
Truman	Dowdy	M
Stephany	Dowell	F
Kobe	Dowling	M
Jase	Downer	M
Deshawn	Downes	M
Augustus	Downey	M
Houston	Downing	M
Teagan	Downs	F
Mina	Doyle	F
Darian	Dozier	M
Blair	Drake	M
Aline	Draper	F
Hans	Drayton	M
Hester	Dreher	F
Earlene	Dressler	F
Waylon	Drew	M
Nita	Dreyer	F
Melva	Driggers	F
Anya	Driscoll	F
Alvaro	Driver	M
Tyra	Drum	F
Concetta	Drummond	F
Lyndsey	Drury	F
Dayna	Dryden	F
Caiden	Du	M
Lessie	DuBois	F
Ronny	DuBose	M
Karyn	DuBourg	F
Itzel	DuCoin	F
Denver	DuPre	M
Kirby	Duarte	M
Delmar	Dube	M
Kiersten	Ducharme	F
Ayanna	Duck	F
Queen	Duckett	F
Frederic	Duckworth	M
Tamera	Duda	F
Meaghan	Dudek	F
Vito	Dudley	M
Danica	Duenas	F
Abram	Duff	M
Barrett	Duffey	M
Kareem	Duffy	M
Lourdes	Dufour	F
Carlo	Dufresne	M
Isabell	Dugan	F
Tammi	Dugas	F
Hollis	Duggan	M
Quintin	Dugger	M
Agustin	Duhon	M
Rosanna	Duke	F
Pierce	Dukes	M
Leeann	Dulaney	F
Donnell	Dull	M
Celina	Dumas	F
Kris	Dumont	M
Edythe	Dunaway	F
Weldon	Dunbar	M
Brenton	Duncan	M
Kory	Dunham	M
Hailee	Dunlap	F
Marci	Dunn	F
Raegan	Dunne	F
Tamra	Dunning	F
Scot	Duong	M
Jayme	Dupont	F
Renae	Dupree	F
Bertie	Dupuis	F
Cash	Duque	M
Kade	Duquette	M
Alden	Duran	M
Clement	Durand	M
Judah	Durant	M
Chelsie	Durbin	F
Anahi	Durden	F
Sheree	Durham	F
Domingo	Durkin	M
Rhiannon	Duron	F
Benita	Durr	F
Lexie	Durst	F
Deon	Dutcher	M
Brantley	Dutton	M
Madge	Duty	F
Madilyn	Duval	F
Maryanne	Duvall	F
Porter	Dvorak	M
Kellen	Dwyer	M
Carlie	Dye	F
Fernanda	Dyer	F
Hiram	Dyke	M
Maci	Dykes	F
Ryker	Dykstra	M
Deena	Dyson	F
Lesly	Eades	F
Tyree	Eads	M
Dayton	Eagan	M
Reyna	Eagle	F
Benito	Ealy	M
Elisha	Earl	F
Kenzie	Earle	F
Kaila	Earley	F
Haleigh	Earls	F
Camron	Early	M
Trevon	Earnest	M
Prince	Easley	M
Maud	Eason	F
Jordon	East	M
Georgette	Easter	F
Madisyn	Easterling	F
Liana	Eastman	F
Gussie	Easton	F
Mitchel	Eastwood	M
Kaye	Eaton	F
Seymour	Eaves	M
Bria	Eberhardt	F
Mitzi	Eberhart	F
Tess	Eberle	F
Rhett	Eberly	M
Jarred	Ebersole	M
Josefina	Ebert	F
Major	Eby	M
Beverley	Echevarria	F
Brayan	Echeverria	M
Krystle	Echols	F
Chadwick	Eck	M
Louella	Ecker	F
Osvaldo	Eckert	M
Braylon	Eckhardt	M
Adrianne	Eckman	F
Bridgett	Eckstein	F
Catharine	Eddy	F
Merrill	Edelman	M
Garret	Eden	M
Maryellen	Edens	F
Jena	Edgar	F
Nehemiah	Edge	M
Kourtney	Edgerton	F
Marylou	Edmiston	F
Markus	Edmond	M
Mohamed	Edmonds	M
Miracle	Edmondson	F
Petra	Edmonson	F
Eddy	Edmunds	M
Lakeisha	Edward	F
Devan	Edwards	M
Gena	Egan	F
Kaelyn	Egbert	F
Wilda	Eggers	F
Tameka	Eggert	F
Rowan	Eggleston	M
Addyson	Ehlers	F
Marilynn	Ehrlich	F
Linwood	Eichelberger	M
Colten	Eicher	M
Roxanna	Eidson	F
Fletcher	Eisenberg	M
Halle	Elam	F
Amari	Elder	M
Cullen	Eldred	M
Estrella	Eldredge	F
Donny	Eldridge	M
Princess	Eley	F
Mariam	Elias	F
Rocio	Elizondo	F
Anika	Elkins	F
Micaela	Eller	F
Cari	Ellingson	F
Maximilian	Ellington	M
Maricela	Elliot	F
Kaley	Elliott	F
Samara	Ellis	F
Basil	Ellison	M
Annabel	Ellsworth	F
Cali	Elmer	F
Colt	Elmore	M
Lilliana	Elrod	F
Braeden	Elston	M
Kaydence	Elwell	F
Ainsley	Elwood	F
Joelle	Ely	F
Lakisha	Emanuel	F
Morton	Embry	M
Trista	Emerick	F
Desirae	Emerson	F
Carmine	Emery	M
Demarcus	Emmons	M
Diann	Emory	F
Rebeca	EnEarl	F
Theron	Encarnacion	M
Nataly	Endicott	F
Royal	Endres	M
Yadira	Eng	F
Kinsley	Engel	F
Arleen	Engelhardt	F
Maryjane	England	F
Janessa	Engle	F
Caryn	Engler	F
Lawanda	Englert	F
Ahmed	English	M
Lulu	Engstrom	F
Stevie	Ennis	M
Clair	Enos	M
Davon	Enright	M
Dara	Enriquez	F
Francisca	Epperson	F
Sharlene	Epps	F
Tianna	Epstein	F
Bailee	Erb	F
Zelda	Erdman	F
Coleen	Erickson	F
Yasmine	Ericson	F
Birdie	Ernest	F
Finn	Ernst	M
Mohammad	Erskine	M
Lyric	Ervin	F
Gia	Erwin	F
Paxton	Escalante	M
Thalia	Escalera	F
Isaias	Escamilla	M
Orion	Escobar	M
Adela	Escobedo	F
Georgie	Esparza	F
Kristal	Espinal	F
Keely	Espino	F
America	Espinosa	F
Augustine	Espinoza	M
Leta	Esposito	F
Aida	Esqueda	F
Dudley	Esquibel	M
Janel	Esquivel	F
Gunner	Estep	M
Alecia	Estes	F
Braydon	Estevez	M
Zella	Estrada	F
Maudie	Estrella	F
Mckayla	Etheridge	F
Ezequiel	Ethridge	M
Madelynn	Etienne	F
Wilhelmina	Etter	F
Brittani	Eubank	F
Mervin	Eubanks	M
Justina	Evangelista	F
Aurelia	Evans	F
Kailyn	Evenson	F
Gunnar	Everett	M
Lizette	Everhart	F
Antwan	Evers	M
Shelton	Eversole	M
Annemarie	Everson	F
Twila	Ewald	F
Kitty	Ewell	F
Kacie	Ewing	F
Jarod	Ezell	M
Anissa	Faber	F
Cyril	Fabian	M
Iona	Fagan	F
Madyson	Fahey	F
Alena	Fain	F
Earle	Fair	M
Luisa	Fairbanks	F
Lilia	Fairchild	F
Reggie	Faircloth	M
Erich	Fairley	M
Vern	Faison	M
Angelita	Fajardo	F
Moshe	Falco	M
Lesa	Falcon	F
Letitia	Falcone	F
Alfreda	Falk	F
Gino	Fall	M
Dessie	Fallon	F
Christen	Falls	F
Maranda	Fan	F
Aspen	Fancher	F
Claudine	Fang	F
Tamia	Fannin	F
Melany	Fanning	F
Florine	Farber	F
Mohammed	Faria	M
Vince	Farias	M
Cherry	Farina	F
Shaina	Faris	F
Dalia	Farkas	F
Katina	Farley	F
Kinley	Farmer	F
Jadyn	Farnham	F
Alva	Farnsworth	M
Ari	Farr	M
Ciera	Farrar	F
Damaris	Farrell	F
Ashanti	Farrington	F
Nigel	Farris	M
Judson	Farrow	M
Jaelyn	Fast	F
Annamarie	Faulk	F
Christin	Faulkner	F
Maia	Faust	F
Lauri	Favela	F
Amalia	Fawcett	F
Marquita	Fay	F
Breana	Fazio	F
Londyn	Fears	F
Cornell	Feaster	M
Aleah	Federico	F
Pansy	Fee	F
Moriah	Feeney	F
Isla	Feinberg	F
Booker	Felder	M
Karlee	Feldman	F
Cori	Feliciano	F
Claud	Felix	M
Kaylyn	Fell	F
Roxana	Feller	F
Mayme	Fellows	F
Leora	Felton	F
Gayla	Felts	F
Buford	Fender	M
Kieran	Feng	M
Arabella	Fenn	F
Evie	Fennell	F
Abbigail	Fenner	F
Jazlyn	Fenton	F
Winona	Fenwick	F
Carlee	Ferguson	F
Ashly	Fernandes	F
Lona	Fernandez	F
Kailee	Fernando	F
Adalyn	Ferrante	F
Tayler	Ferrara	F
Foster	Ferrari	M
Isis	Ferraro	F
Aubrie	Ferreira	F
Dirk	Ferrell	M
Lorelei	Ferrer	F
Tevin	Ferris	M
Chaya	Ferro	F
Kori	Ferry	F
River	Fick	M
Freeman	Fidler	M
Korey	Fiedler	M
Demetria	Field	F
Denice	Fielder	F
Marlena	Fielding	F
Retha	Fields	F
Roselyn	Fierro	F
Davion	Fife	M
Freida	Figueroa	F
Deangelo	Fike	M
Millicent	Fils-Aime	F
Gideon	Finch	M
Valencia	Fincher	F
Miley	Findley	F
Elle	Fine	F
Giovanna	Finger	F
Liberty	Fink	F
Triston	Finkelstein	M
Rigoberto	Finley	M
Veda	Finn	F
Devonte	Finnegan	M
Maverick	Finney	M
Daren	Fiore	M
Kennith	Firestone	M
Margot	Fischer	F
Scottie	Fish	M
Annabella	Fisher	F
Racheal	Fishman	F
Lucretia	Fisk	F
Leota	Fitch	F
Jaron	Fite	M
Portia	Fitts	F
Fidel	FitzJames	M
Wilford	FitzRandolf	M
Marlee	Fitzgerald	F
Herschel	Fitzpatrick	M
Marva	Fitzsimmons	F
Jamel	Fix	M
Zayden	Flack	M
Wilburn	Flagg	M
Vonda	Flaherty	F
Robby	Flanagan	M
Danette	Flanders	F
Ivette	Flanigan	F
Amira	Flannery	F
Felecia	Flatt	F
Nan	Fleck	F
Dusty	Fleming	M
Alvina	Flemming	F
Deidra	Fletcher	F
Judi	Fleury	F
Lilah	Flick	F
Michel	Flinn	M
Shayne	Flint	M
Nikita	Flood	F
Mikel	Flora	M
Shea	Florence	F
Cordelia	Flores	F
Kolton	Florez	M
Vida	Florio	F
Cristopher	Flory	M
Cayla	Flournoy	F
Domenic	Flowers	M
Maximiliano	Floyd	M
Merry	Flynn	F
Manuela	Fogarty	F
Rowena	Fogel	F
Nathanial	Fogg	M
Deann	Fogle	F
Gregorio	Foley	M
Rosario	Folk	F
Jett	Folsom	M
Trace	Foltz	M
Brook	Fong	F
Patience	Fonseca	F
Kathi	Fontaine	F
Layne	Fontana	M
Alphonse	Fontenot	M
Shantel	Foote	F
Breanne	Forbes	F
Elmo	Ford	M
Winfred	Forde	M
Marybeth	Fordham	F
Everette	Fore	M
Jolie	Foreman	F
Sandi	Forest	F
Phoenix	Forester	M
Beryl	Forman	F
Catrina	Forney	F
Mariela	Forrest	F
Gilda	Forrester	F
Kenton	Forster	M
Dinah	Forster-Nietzsche	F
Gemma	Forsyth	F
Shellie	Forsythe	F
Deven	Fort	M
Delphine	Forte	F
Tatyana	Fortenberry	F
Ashlie	Fortier	F
Mandi	Fortin	F
Margret	Fortner	F
Pasquale	Fortney	M
Lavern	Fortune	M
Kacey	Foss	F
Berniece	Foss-Rose	F
Kane	Foster	M
Octavio	Fountain	M
Lenard	Fournier	M
Marisela	Foust	F
Chana	Fouts	F
Tessie	Fowler	F
Hershel	Fowlkes	M
Lacie	Fox	F
Randell	Foy	M
Lidia	Fraley	F
Latanya	Frame	F
Iliana	France	F
Felicity	Francis	F
Ione	Francisco	F
Cordell	Franco	M
Tera	Francois	F
Karli	Frank	F
Rosalee	Franke	F
Lon	Frankel	M
Kaylynn	Franklin	F
Muhammad	Franks	M
Karrie	Frantz	F
Johnna	Franz	F
Haven	Franzen	F
Jimena	Fraser	F
Lawson	Frasier	M
Denzel	Frausto	M
Macey	Frazee	F
Dayana	Frazer	F
Karly	Frazier	F
Kolby	Frederick	M
Debby	Fredericks	F
Dionne	Fredrick	F
Bernardo	Fredrickson	M
Alycia	Free	F
Jaquan	Freed	M
Jamari	Freedman	M
Vada	Freeland	F
Farrah	Freeman	F
Theodora	Freese	F
Vivienne	Freitag	F
Adelyn	Freitas	F
Rolland	French	M
Antony	Freund	M
Treva	Frey	F
Lauretta	Freytag-Loringhoven	F
Celine	Frias	F
Scarlet	Frick	F
Hank	Fricke	M
Oma	Friday	F
Christiana	Fried	F
Chastity	Friedman	F
Ayana	Friedrich	F
Iola	Friel	F
Gonzalo	Friend	M
Lanny	Frierson	M
Christal	Fries	F
Enoch	Friesen	M
Marquise	Frisch	M
Heriberto	Fritsch	M
Caren	Fritts	F
Pattie	Fritz	F
Garth	Frizzell	M
Celestine	Froehlich	F
Melodie	Frost	F
Madonna	Fry	F
Jacquelin	Frye	F
Lura	Fryer	F
Luciano	Fu	M
Monika	Fuchs	F
Cohen	Fuentes	M
Cortez	Fugate	M
Davin	Fuhrman	M
Tisha	Fulcher	F
Jaimie	Fulk	F
Shanice	Fulkerson	F
Kelsi	Fuller	F
Bud	Fullerton	M
Fanny	Fullmer	F
Coral	Fulmer	F
Nasir	Fulton	M
Kristofer	Fultz	M
Laney	Funderburk	F
Darien	Fung	M
Ulises	Funk	M
Janiya	Fuqua	F
Savanah	Furlong	F
Nestor	Furman	M
Skyla	Furr	F
Barton	Furtado	M
Unknown	Fusco	F
Chauncey	Fussell	M
Anaya	Futch	F
Karson	Futrell	M
Karlie	Gabbard	F
Haylie	Gabel	F
Carmelo	Gable	M
Lashonda	Gabriel	F
Ibrahim	Gaddis	M
Lisette	Gaddy	F
Izaiah	Gadson	M
Lemuel	Gaffney	M
Elouise	Gage	F
Kasandra	Gagliardi	F
Mckinley	Gagne	M
Talon	Gagnon	M
Lettie	Gainer	F
Danial	Gaines	M
Yahir	Gainey	M
Joslyn	Gaitan	F
Patrica	Gaither	F
Tana	Galan	F
Wilfredo	Galarza	M
Danika	Galaviz	F
Reina	Galbraith	F
Sade	Galbreath	F
Jerrod	Gale	M
Alysha	Galicia	F
Karol	Galindo	F
Chaz	Gall	M
Bradly	Gallagher	M
Bernie	Gallant	M
Antionette	Gallardo	F
Alysia	Gallego	F
Latrice	Gallegos	F
Maegan	Gallo	F
Erna	Galloway	F
Janiyah	Galvan	F
Maeve	Galvez	F
Julien	Galvin	M
Kallie	Gambino	F
Adelina	Gamble	F
Suzanna	Gamboa	F
Kenna	Gambrell	F
Cherish	Gamez	F
Amara	Gammon	F
Rayna	Gandhi	F
Lucian	Gandy	M
Dottie	Gann	F
Suzan	Gannon	F
Raina	Gant	F
Tiffanie	Gantt	F
Brant	Gao	M
Jacques	Gaona	M
Georgianna	Garay	F
Cliff	Garber	M
Philomena	Garces	F
Starr	Garcia	F
Johan	Gard	M
Maurine	Gardiner	F
Abe	Gardner	M
Jadon	Garduno	M
Stacia	Garfield	F
Hana	Garibay	F
Marlys	Garland	F
Jaylin	Garman	M
Jax	Garmon	M
Anabel	Garner	F
Bo	Garnett	M
Enid	Garofalo	F
Gisselle	Garrett	F
Dovie	Garrido	F
Milagros	Garris	F
Annalise	Garrison	F
Dannie	Garrity	M
Laci	Gartner	F
Olin	Garver	M
Berenice	Garvey	F
Nova	Garvin	F
Jairo	Gary	M
Emmitt	Garza	M
Thea	Gaskill	F
German	Gaskin	M
Roxann	Gaskins	F
Katelin	Gaspar	F
Kennedi	Gaspard	F
Elda	Gasper	F
Mekhi	Gass	M
Liz	Gast	F
Raymundo	Gastelum	M
Malissa	Gaston	F
Brycen	Gates	M
Tristin	Gatewood	M
Amani	Gatlin	F
Dino	Gatto	M
Jaylon	Gaudet	M
Alonso	Gaul	M
Allene	Gault	F
Annetta	Gause	F
Lorine	Gauthier	F
Georgiana	Gavin	F
Kirstin	Gay	F
Essence	Gayle	F
Rod	Gaylord	M
Andria	Gaynor	F
Ansley	Gaytan	F
Rob	Gearhart	M
Jovan	Geary	M
Jeanna	Gebel-Williams	F
Harriette	Gebhardt	F
Kadence	Gee	F
Kristyn	Geer	F
Shyanne	Gehring	F
Alene	Geiger	F
Journey	Geisler	F
Ferdinand	Geist	M
Adalynn	Geller	F
Venus	Gendron	F
Kaci	Genovese	F
Griselda	Gentile	F
Magdalene	Gentry	F
Reta	George	F
Rico	Georges	M
Holli	Gerald	F
Fabiola	Gerard	F
Evangelina	Gerber	F
Kerrie	Gerdes	F
Robbin	Gerhardt	F
Doretha	Gerhart	F
Luanne	Gerlach	F
Rohan	Germain	M
Natalee	German	F
Nakia	Gervais	F
Rodrick	Getz	M
Lolita	Geyer	F
Hassan	Gibbons	M
Alia	Gibbs	F
Theo	Gibson	M
Gertie	Giddens	F
Delois	Giddings	F
Lyndon	Giese	M
Jacoby	Gifford	M
Lucius	Giglio	M
Amiyah	Gil	F
Wilton	Gilbert	M
Remington	Gilbertson	M
Dario	Gilbreath	M
Lyman	Gilchrist	M
Belen	Giles	F
Aylin	Gill	F
Isabela	Gillen	F
Delma	Gillespie	F
Brodie	Gillett	M
Keven	Gillette	M
Raleigh	Gilley	M
Jerrold	Gilliam	M
Errol	Gilligan	M
Ivory	Gilliland	F
Valentin	Gillis	M
Aracely	Gillispie	F
Stan	Gillman	M
Nico	Gillum	M
Brigitte	Gilman	F
Benton	Gilmer	M
Matteo	Gilmore	M
Josef	Gilpin	M
Linnea	Gilson	F
Kami	Gilstrap	F
Amya	Gingerich	F
Eliseo	Ginn	M
Agatha	Ginsberg	F
Dahlia	Giordano	F
Misti	Gipson	F
Brennen	Giraldo	M
Zoie	Girard	F
Ally	Giron	F
Sarina	Giroux	F
Richelle	Gist	F
Jules	Givens	M
Fredric	Gladden	M
Alexandrea	Gladney	F
Myla	Glaser	F
Clementine	Glasgow	F
Federico	Glass	M
Chantal	Glaze	F
Milford	Gleason	M
Coby	Glenn	M
Lakesha	Glick	F
Fallon	Glidden	F
Maliyah	Glover	F
Zechariah	Glynn	M
Kendal	Goad	F
Milan	Gober	M
Ambrose	Goble	M
Mariano	Goddard	M
Darleen	Godfrey	F
Benedict	Godinez	M
Arely	Godoy	F
Tyrese	Godsey	M
Corrie	Godwin	F
Jazmyn	Goebel	F
Vesta	Goetz	F
Ofelia	Goff	F
Mac	Goforth	M
Jed	Goins	M
Estevan	Gold	M
Tena	Goldberg	F
Odis	Golden	M
Thad	Golding	M
Beckett	Goldman	M
Marjory	Goldsmith	F
Gianni	Goldstein	M
Noble	Gomes	M
Verda	Gomez	F
Buster	Goncalves	M
Lindy	Gong	F
Jamaal	Gonsalez	M
Lorri	Gonsalves	F
Omer	Gonzales	M
Jacquline	Gonzalez	F
Cristy	Gooch	F
Dashawn	Good	M
Raelynn	Goodall	F
Geri	Goode	F
Edison	Goodell	M
Sunny	Gooden	F
Shakira	Goodin	F
Shanda	Gooding	F
Ryann	Goodman	F
Amina	Goodrich	F
Oren	Goodson	M
Belva	Goodwin	F
Charla	Goolsby	F
Estela	Gordon	F
Elliana	Gordon-Levitt	F
Stephon	Gore	M
Renata	Gorham	F
Dorene	Gorman	F
Carli	Gormley	F
Jaida	Gorski	F
Charlee	Gosnell	F
Orval	Goss	M
Darrick	Gosselin	M
Bree	Gossett	F
Newton	Goto	M
Germaine	Gott	F
Emile	Gottlieb	M
Linnie	Gottschalk	F
Daria	Gough	F
Bertram	Gould	M
Chaim	Goulet	M
Broderick	Gourley	M
Yazmin	Gower	F
Katarina	Graber	F
Lucien	Grabowski	M
Lizeth	Grace	F
Mireya	Gracia	F
Eloy	Grady	M
Jaydon	Graf	M
Arron	Graff	M
Tylor	Gragg	M
Karter	Graham	M
Ryland	Granado	M
Barbra	Granados	F
Antonette	Grande	F
Starla	Granger	F
Sydnee	Grant	F
Kayley	Grantham	F
Marcelo	Grass	M
Tod	Grasso	M
Mazie	Grau	F
Cathrine	Graves	F
Cindi	Gray	F
Armani	Grayson	M
Mose	Graziano	M
Marques	Greathouse	M
Raymon	Greaves	M
Hoyt	Greco	M
Napoleon	Greeley	M
Donavan	Green	M
Jaycee	Green-Ellis	F
Delmer	Greenberg	M
Ona	Greene	F
Cale	Greenfield	M
Aliya	Greenlee	F
Kaia	Greenwald	F
Turner	Greenway	M
Stanford	Greenwell	M
Elana	Greenwood	F
Devante	Greer	M
Bronson	Gregg	M
Velda	Gregoire	F
Marcela	Gregory	F
Caylee	Greiner	F
Jeana	Grenier	F
Zaria	Gresham	F
Aja	Grey	F
Kip	Grice	M
Paloma	Grider	F
Mira	Griego	F
Una	Grier	F
Emelia	Griffin	F
Dwain	Griffis	M
Keon	Griffith	M
Giuliana	Griffiths	F
Columbus	Grigg	M
Danita	Griggs	F
Layton	Grigsby	M
Kala	Grijalva	F
Kia	Grillo	F
Shonda	Grim	F
Roma	Grimaldi	F
Astrid	Grimes	F
Deonte	Grimm	M
Kaya	Grimsley	F
Leif	Grisham	M
Finley	Grissom	F
Kianna	Griswold	F
Destiney	Groce	F
Iesha	Groff	F
Kenyon	Grogan	M
Jerold	Groom	M
Nash	Grooms	M
Renita	Grose	F
Daquan	Gross	M
Elida	Grossman	F
Zack	Groth	M
Darby	Grove	F
Dorris	Grover	F
Adriel	Groves	M
Pamala	Grow	F
Isidro	Grubb	M
Peggie	Grubbs	F
Cletus	Grube	M
Candi	Gruber	F
Emmalee	Guajardo	F
Efren	Guardado	M
Jayleen	Guarino	F
Nicky	Gudino	M
Charleen	Guenther	F
Magnolia	Guerin	F
Benson	Guerra	M
Simeon	Guerrero	M
Adrien	Guess	M
Samson	Guest	M
Lashawn	Guevara	F
Hellen	Guffey	F
Ellsworth	Guido	M
Elvia	Guidry	F
Dominik	Guillen	M
Destini	Guillory	F
Myah	Guillot	F
Alesha	Guinn	F
Aliza	Gulley	F
Lissette	Gunderson	F
Vernice	Gunn	F
Marilee	Gunter	F
Hettie	Gunther	F
Warner	Guo	M
Valorie	Gupta	F
Halie	Gurley	F
Kamila	Gurney	F
Juliann	Gurrola	F
Jabari	Gurule	M
Sherlyn	Gustafson	F
Sharyn	Gustin	F
Dimitri	Guthrie	M
Olen	Gutierrez	M
Elroy	Guy	M
Justus	Guyer	M
Ginny	Guyton	F
Palmer	Guzman	M
Landyn	Gwin	M
Berta	Gwinn	F
Brisa	Ha	F
Austen	Haag	M
Zora	Haas	F
Alesia	Haase	F
Daron	Haber	M
Uriah	Hack	M
Maren	Hacker	F
Tamela	Hackett	F
Aryanna	Hackney	F
Lyn	Hackworth	F
Jaylene	Haddad	F
Aric	Hadden	M
Jaylynn	Haddock	F
Burl	Hadley	M
Dewitt	Hafner	M
Tyron	Hagan	M
Ami	Hagedorn	F
Roseanne	Hageman	F
Sabina	Hagen	F
Misael	Hager	M
Omari	Hagerman	M
Bess	Hagerty	F
Joana	Haggard	F
Vernell	Haggerty	F
Mathilda	Hagler	F
Asha	Hague	F
Alpha	Hahn	F
Luciana	Haight	F
Imelda	Haile	F
Nedra	Hailey	F
Darrius	Haines	M
Montana	Hair	F
Rosalia	Haire	F
Star	Hairston	F
Zara	Halbert	F
Anabelle	Hale	F
Kalyn	Hales	F
Laureen	Haley	F
Mariann	Hall	F
Ronan	Haller	M
Devyn	Hallett	F
Aiyana	Halley	F
Abner	Halliday	M
Carmel	Hallman	F
Mathias	Hallmark	M
Sol	Hallock	M
Yessenia	Halloran	F
Susannah	Halpin	F
Alijah	Halsey	M
Danelle	Halstead	F
Genaro	Halter	M
Davina	Halverson	F
Cecily	Halvorson	F
Giana	Ham	F
Jaliyah	Hamann	F
Tonja	Hamblin	F
Lenny	Hambrick	M
Maryjo	Hamby	F
Shelli	Hamel	F
Evalyn	Hamer	F
Rogers	Hamill	M
Enzo	Hamilton	M
Kole	Hamlett	M
Dorcas	Hamlin	F
Kimora	Hamm	F
Aleena	Hammack	F
Rubye	Hammel	F
Garrison	Hammer	M
Marcellus	Hammett	M
Sherrill	Hammock	F
Vincenzo	Hammond	M
Dandre	Hammonds	M
Jamila	Hammons	F
Rubi	Hampton	F
Tressa	Hamrick	F
Michell	Han	F
Jaunita	Hance	F
Aletha	Hancock	F
Dangelo	Hand	M
Kason	Handley	M
Brylee	Handy	F
Francesco	Hanes	M
Adonis	Haney	M
Kenia	Hang	F
Rubin	Hankins	M
Jerrell	Hanks	M
Salma	Hanley	F
Kale	Hanlon	M
Collette	Hann	F
Niki	Hanna	F
Salina	Hannah	F
Carmelita	Hannan	F
Jacey	Hannigan	F
Stefani	Hannon	F
Quinten	Hanrahan	M
Socorro	Hansen	F
Arden	Hanson	M
Keagan	Harbaugh	M
Alessandro	Harbin	M
Dortha	Harbison	F
Andreas	Hard	M
Braylen	Hardaway	M
Ruthann	Hardee	F
Leia	Hardeman	F
Garnet	Harden	F
Alysa	Harder	F
Ima	Hardesty	F
Tad	Hardin	M
Xiomara	Harding	F
Alyse	Hardison	F
Zola	Hardman	F
Ariella	Hardwick	F
Demi	Hardy	F
Mercy	Hare	F
Raheem	Hargett	M
Yaretzi	Hargis	F
Twyla	Hargrave	F
Huey	Hargrove	M
Karley	Harker	F
Samir	Harkins	M
Kaycee	Harkness	F
Mimi	Harlan	F
Iker	Harless	M
Leonora	Harley	F
Tosha	Harlow	F
Carleen	Harman	F
Hilton	Harmon	M
Corinna	Harms	F
Ike	Harness	M
Dani	Harney	F
Giancarlo	Haro	M
Nikole	Harold	F
Kandice	Harp	F
Moira	Harper	F
Shyla	Harr	F
Abril	Harrell	F
Jenelle	Harrelson	F
Brynlee	Harrigan	F
Lyndsay	Harriman	F
Addisyn	Harrington	F
Yareli	Harris	F
Edwardo	Harris-Reid	M
Maryam	Harrison	F
Duke	Harrod	M
Zariah	Harrold	F
Kimber	Harry	F
Melvina	Hart	F
Flor	Harter	F
Siobhan	Hartford	F
Jamil	Hartley	M
Floy	Hartman	F
Tory	Hartmann	M
Kisha	Hartnett	F
Cristobal	Hartung	M
Gracelyn	Hartwell	F
Lainey	Hartwig	F
Kayleen	Hartzell	F
Burt	Harvey	M
Kinsey	Harwell	F
Arlie	Harwood	M
Kaliyah	Hasan	F
Matias	Hash	M
Leandra	Haskell	F
Tawana	Haskins	F
Shiloh	Hass	F
Darion	Hassan	M
Theda	Hassell	F
Ace	Hastings	M
Westley	Hasty	M
Wilber	Hatch	M
Marlyn	Hatcher	F
Rikki	Hatchett	F
Emmy	Hatfield	F
Jamey	Hathaway	M
Donn	Hatley	M
Elyssa	Hatten	F
Janeen	Hatton	F
Dania	Hauck	F
Felton	Haug	M
Rey	Haugen	M
Arlen	Haught	M
Vikki	Haun	F
Terese	Haupt	F
Krysta	Hauser	F
Lue	Havens	F
Nanci	Hawes	F
Eryn	Hawk	F
Winter	Hawkes	F
Idella	Hawkins	F
Teressa	Hawks	F
Santino	Hawley	M
Aurelio	Haworth	M
Eboni	Hawthorne	F
Cason	Hay	M
Kellan	Hayden	M
Evelin	Hayes	F
Leighton	Haygood	M
Kassie	Hayman	F
Latosha	Haynes	F
Chantelle	Haynie	F
Haywood	Hays	M
Allyssa	Hayward	F
Jaylah	Haywood	F
Johnson	Hazel	M
Madalynn	Hazelton	F
Blanch	Hazelwood	F
Marcelino	Hazen	M
Sloane	Hazlett	F
Stanton	He	M
Audrina	Head	F
Kayli	Headley	F
Stormy	Headrick	F
Laquita	Heal	F
Artie	Healey	F
Ashely	Healy	F
Harmon	Heard	M
Richie	Hearn	M
Lani	Heath	F
Bettina	Heaton	F
Otha	Hebert	M
Unique	Hecht	F
Lavina	Heck	F
Rosita	Hecker	F
Ardis	Heckman	F
Sharla	Hedges	F
Miller	Hedrick	M
Joycelyn	Heffernan	F
Jacky	Heffner	M
Rhys	Heflin	M
Yaritza	Hefner	F
Caryl	Heil	F
Miah	Heilman	F
Joleen	Heim	F
Aleta	Hein	F
Nelly	Heine	F
Toney	Heinrich	M
Danae	Heintz	F
Hortense	Heinz	F
Lonny	Heiser	M
Mittie	Heisler	F
Blaise	Held	M
Dillan	Heller	M
Sariah	Hellman	F
Elia	Helm	F
Valentino	Helmer	M
Nannette	Helmick	F
Lucero	Helms	F
Averie	Helton	F
Pearline	Hembree	F
Jaelynn	Hemingway	F
Juli	Hemphill	F
Livia	Hendershot	F
Lavon	Henderson	F
Raelyn	Hendrick	F
Lexus	Hendricks	F
Britany	Hendrickson	F
Arjun	Hendrix	M
Alexandro	Hendry	M
Chiquita	Henke	F
Sullivan	Henkel	M
Emerald	Henley	F
Karon	Hennessey	F
Darci	Hennessy	F
Archer	Henning	M
Braiden	Henriquez	M
Shameka	Henry	F
Vanesa	Hensel	F
Verla	Henshaw	F
Braelyn	Hensley	F
Yosef	Henson	M
Eliot	Hepler	M
Bonny	Her	F
Marlo	Herbert	F
Meta	Herbst	F
Keyla	Herd	F
Charline	Heredia	F
Carlotta	Herman	F
Kandace	Hermann	F
Jorden	Hermosillo	M
Adell	Hernandes	F
Noelia	Hernandez	F
Matthias	Herndon	M
Dereck	Herold	M
Lars	Herr	M
Myrtis	Herren	F
Travon	Herrera	M
Fritz	Herrick	M
Trever	Herrin	M
Leone	Herring	F
Messiah	Herrington	M
Gaylord	Herrmann	M
Annabell	Herron	F
Chanda	Hershberger	F
Khadijah	Hershey	F
Kaela	Herzog	F
Maleah	Hess	F
Valentine	Hesse	M
Xzavier	Hester	M
Eloisa	Hetrick	F
Carrol	Hewett	M
Katerina	Hewitt	F
Boston	Heyward	M
Margarette	Hiatt	F
Buck	Hibbard	M
Adriane	Hibbs	F
Bryn	Hickerson	F
Murphy	Hickey	M
Keila	Hickman	F
Baby	Hicks	M
Tristian	Hickson	M
Arnulfo	Hidalgo	M
Taliyah	Higdon	F
Leatha	Higginbotham	F
Nicki	Higgins	F
Shaylee	Higgs	F
Dawna	High	F
Atticus	Hight	M
Jamarion	Hightower	M
Rivka	Hilbert	F
Brittni	Hilburn	F
Lazaro	Hildebrand	M
Carolynn	Hildebrandt	F
Kian	Hildreth	M
Russ	Hileman	M
Siena	Hill	F
Anais	Hillard	F
Darron	Hiller	M
Lucie	Hilliard	F
Mariel	Hillis	F
Calista	Hillman	F
Orpha	Hills	F
Shaniya	Hilton	F
Maribeth	Himes	F
Dayanara	Hindman	F
Emmie	Hinds	F
Jerod	Hines	M
Kaylen	Hinkle	F
Maybelle	Hinman	F
Leandro	Hinojosa	M
Kraig	Hinrichs	M
Lilyana	Hinshaw	F
Jessi	Hinson	F
Leander	Hinton	M
Antwon	Hintz	M
Seamus	Hinz	M
Saige	Hipp	F
Selene	Hirsch	F
Angus	Hitchcock	M
Shyann	Hite	F
Jackeline	Hitt	F
Sky	Hix	F
Kamden	Hixon	M
Hezekiah	Hixson	M
Felisha	Ho	F
Cedrick	Hoag	M
Cinthia	Hoagland	F
Kathryne	Hoang	F
Leatrice	Hobbs	F
Golda	Hobson	F
Amaris	Hoch	F
Hyman	Hochstetler	M
Art	Hock	M
Josette	Hodge	F
Arlo	Hodges	M
Verne	Hodgson	M
Denisse	Hodson	F
Sharonda	Hofer	F
Franklyn	Hoff	M
Nila	Hoffer	F
Jessika	Hoffman	F
Normand	Hoffmann	M
Antone	Hofmann	M
Jalisa	Hogan	F
Rashawn	Hogg	M
Vickey	Hogue	F
Adria	Hoke	F
Nevin	Holbert	M
Shante	Holbrook	F
Lida	Holcomb	F
Johana	Holcombe	F
Shay	Holden	F
Eliezer	Holder	M
Franco	Holguin	M
Demario	Holiday	M
Knox	Holladay	M
Kaylah	Holland	F
Bryana	Hollander	F
Ivonne	Hollenbeck	F
Jedidiah	Holler	M
Miya	Holley	F
Adina	Holliday	F
Hamilton	Hollifield	M
Estefania	Hollinger	F
Brigid	Hollingsworth	F
Kelton	Hollins	M
Gaye	Hollis	F
Teena	Hollister	F
Monserrat	Holloman	F
Sommer	Holloway	F
Douglass	Hollowell	M
Karolyn	Holly	F
Hobert	Holm	M
Litzy	Holman	F
Jonnie	Holmberg	F
Korbin	Holmes	M
Abdullah	Holst	M
Nathen	Holt	M
Ivana	Holton	F
Lovie	Holtz	F
Pennie	Hom	F
Stephenie	Homan	F
Anson	Homer	M
Madilynn	Honaker	F
Shirlee	Honeycutt	F
Amiya	Hong	F
Baron	Hood	M
Kamron	Hook	M
Novella	Hooker	F
Derrell	Hooks	M
Ephraim	Hooper	M
Venita	Hooten	F
Hayes	Hoover	M
Venessa	Hope	F
Cannon	Hopkins	M
Breann	Hopp	F
Waldo	Hoppe	M
Evette	Hopper	F
Maira	Hopson	F
Oralia	Horan	F
Berry	Horn	M
Jakayla	Horne	F
Niko	Horner	M
Ashli	Horning	F
Selah	Hornsby	F
Williams	Horowitz	M
Abigayle	Horsley	F
Leigha	Horst	F
Lesli	Horton	F
Aretha	Horvath	F
Danyelle	Hoskins	F
Keeley	Hoss	F
Saniya	Hostetler	F
Evelynn	Hostetter	F
Missy	Hotchkiss	F
Latricia	Houck	F
Giovani	Hough	M
Mellissa	Houghton	F
Constantine	Houk	M
Chet	Houle	M
Karmen	House	F
Marnie	Houser	F
Alba	Houston	F
Sherwood	Hovey	M
Eleanora	Howard	F
Cathie	Howarth	F
Shanika	Howe	F
Edgardo	Howell	M
Roseanna	Howerton	F
Ardith	Howes	F
Nathaly	Howie	F
Brigette	Howland	F
Rollin	Howlett	M
Ember	Hoy	F
Giovanny	Hoyle	M
Leopoldo	Hoyt	M
Isadore	Hsieh	M
Valery	Hsu	F
Carolann	Hu	F
Leonor	Hua	F
Jayde	Huang	F
Jensen	Hubbard	M
Janay	Hubbell	F
Amelie	Huber	F
Natalya	Hubert	F
Samira	Huck	F
Nicolle	Huckaby	F
Rhianna	Hudak	F
Jasmyn	Huddleston	F
Karma	Hudgens	F
Kattie	Hudgins	F
Garfield	Hudson	M
Talmadge	Hudspeth	M
Vivien	Huebner	F
Syble	Huerta	F
Corrina	Huey	F
Yusuf	Huff	M
Leyla	Huffman	F
Demond	Huggins	M
Val	Hughes	M
Kandi	Hughey	F
Brandan	Hui	M
Kristan	Huizar	F
Aloysius	Hulbert	M
Alfonzo	Hulett	M
Easter	Hull	F
Walton	Hulse	M
Nelle	Hulsey	F
Khalid	Humble	M
Britton	Hume	M
Rayford	Humes	M
Yoselin	Hummel	F
Lisbeth	Humphrey	F
Era	Humphreys	F
Channing	Humphries	M
Elden	Hundley	M
Cheryle	Hung	F
Jaylee	Hunley	F
Granville	Hunnicutt	M
Alexzander	Hunsaker	M
Nylah	Hunt	F
Oleta	Hunter	F
Judie	Huntington	F
Draven	Huntley	M
Lizabeth	Hupp	F
Brandee	Hurd	F
Gerri	Hurley	F
Tariq	Hurst	M
Hamza	Hurt	M
Amberly	Hurtado	F
Jonna	Huskey	F
Edd	Huss	M
Mitch	Hussain	M
Deron	Hussey	M
Andra	Husted	F
Aryana	Huston	F
Camren	Hutchens	M
Arya	Hutcherson	F
Fawn	Hutcheson	F
Akeem	Hutchings	M
Nichelle	Hutchins	F
Hulda	Hutchinson	F
Reyes	Hutchison	M
Jovani	Hutson	M
Mauro	Hutto	M
Dax	Hutton	M
Reanna	Huynh	F
Dorsey	Hwang	M
Serina	Hyatt	F
Coty	Hyde	M
Boyce	Hyder	M
Kelsea	Hyland	F
Keshia	Hylton	F
Kaiya	Hyman	F
Sarahi	Hynes	F
Darcie	Ibanez	F
Orin	Ibarra	M
Abagail	Ibrahim	F
Malaysia	Iglesias	F
Shelbie	Ignacio	F
Dock	Infante	M
Dian	Ingalls	F
Shelbi	Ingersoll	F
Oswaldo	Ingle	M
Ford	Ingraham	M
Shamar	Ingram	M
Abdul	Iniguez	M
Sheridan	Inman	F
Tamar	Irby	F
Rupert	Ireland	M
Brandt	Irish	M
Keshawn	Irizarry	M
Katlin	Irons	F
Joellen	Irvin	F
Yajaira	Irvine	F
Mozelle	Irving	F
Ishmael	Irwin	M
Tressie	Isaac	F
Samual	Isaacs	M
Jenni	Isaacson	F
Gustave	Isbell	M
Hardy	Islam	M
Prudence	Islas	F
Tanesha	Isom	F
Joi	Ison	F
Hailie	Israel	F
Ines	Ito	F
Junius	Iverson	M
Orrin	Ives	M
Harland	Ivey	M
Karie	Ivie	F
Branson	Ivory	M
Marcelle	Ivy	F
Shaquille	Izquierdo	M
Isai	Izzo	M
Rosina	Jablonski	F
Semaj	Jacinto	M
Charisse	Jack	F
Kandy	Jackman	F
Kylan	Jacks	M
Tatianna	Jackson	F
Rona	Jacob	F
Jerrie	Jacobo	F
Ramsey	Jacobs	M
Annalee	Jacobsen	F
Ernestina	Jacobson	F
Frida	Jacoby	F
Dontae	Jacques	M
Melonie	Jaeger	F
Akira	Jaffe	F
Adella	Jahn	F
Stephani	Jaime	F
Norine	Jaimes	F
Kortney	Jain	F
Filomena	Jamerson	F
Tre	James	M
Meg	Jameson	F
Kalvin	Jamieson	M
Abigale	Jamison	F
Maximo	Janes	M
Kesha	Jang	F
Donita	Jankowski	F
Elvera	Jansen	F
Derik	Janssen	M
Garrick	Jaquez	M
Jannette	Jara	F
Zakary	Jaramillo	M
Chyna	Jarman	F
Merritt	Jarrell	M
Amirah	Jarrett	F
Bambi	Jarvis	F
Katia	Jasper	F
Artis	Jasso	M
Jerilyn	Jauregui	F
Cami	Javier	F
Concepcion	Jaworski	F
Candis	Jay	F
Jocelynn	Jaynes	F
Kamari	Jean	M
Shannan	Jeanbaptiste	F
Trena	Jeffcoat	F
Blaze	Jefferies	M
Jacalyn	Jeffers	F
Karis	Jefferson	F
Eldridge	Jeffery	M
Romona	Jeffrey	F
Albertha	Jeffries	F
Jaidyn	Jenkins	F
Vina	Jenks	F
Joanie	Jennings	F
Winfield	Jensen	M
Domonique	Jenson	F
Jeanetta	Jernigan	F
Trinidad	Jerome	M
Zena	Jessen	F
Louann	Jessup	F
Emmet	Jester	M
Jazlynn	Jeter	F
Rosendo	Jett	M
Areli	Jewell	F
Mai	Jewett	F
Violeta	Jiang	F
Shaniqua	Jimenez	F
Priya	Jin	F
Lucio	Jobe	M
Delano	Joe	M
Roxane	Johansen	F
Shanta	Johanson	F
Deacon	John	M
Latonia	Johns	F
Maximillian	Johnsen	M
Malcom	Johnson	M
Soren	Johnston	M
Donavon	Johnstone	M
Finnegan	Joiner	M
Sydni	Jolley	F
Regis	Jolly	M
Koby	Jonas	M
Lupita	Jones	F
Mahlon	Jordan	M
Giuseppe	Jordon	M
Alvis	Jorge	M
Curtiss	Jorgensen	M
Greggory	Jorgenson	M
Shamika	Jose	F
Jessenia	Joseph	F
Lilianna	Joshi	F
Treasure	Joslin	F
Alani	Joy	F
Dejuan	Joyce	M
Elwin	Joyner	M
Annalisa	Juan	F
Yasmeen	Juarez	F
Darline	Judd	F
Saniyah	Judge	F
Shantell	Judkins	F
Marshal	Judson	M
Demarco	Judy	M
Hayward	Julian	M
Sherie	Juliano	F
Jair	Julien	M
Rihanna	Jung	F
Sunshine	Jurado	F
Linsey	Justice	F
Keyon	Justus	M
Shira	Kahl	F
Deshaun	Kahler	M
Shon	Kahn	M
Jamarcus	Kain	M
Anders	Kaiser	M
Sincere	Kaminski	M
Claudio	Kaminsky	M
Yuliana	Kane	F
Delvin	Kang	M
Arther	Kangas	M
Domenick	Kao	M
Lanette	Kaplan	F
Charissa	Karas	F
Pilar	Karl	F
Fran	Karnes	F
Ayesha	Karp	F
Kathlyn	Karr	F
Marquez	Kasper	M
Makena	Kato	F
Ronaldo	Katz	M
Brinley	Kauffman	F
Alda	Kaufman	F
Marita	Kaufmann	F
Nikolai	Kaur	M
Shae	Kavanagh	F
Tawnya	Kavanaugh	F
Evonne	Kay	F
Kalie	Kaye	F
Breonna	Kaylor	F
Sydnie	Keane	F
Jacquelynn	Kearney	F
Marlen	Kearns	F
Glynn	Keating	M
Leisa	Keaton	F
Salena	Keck	F
Savana	Kee	F
Marvel	Keefe	F
Albina	Keefer	F
Gwyneth	Keegan	F
Christene	Keel	F
Isela	Keeler	F
Taya	Keeley	F
Adelle	Keeling	F
Mika	Keen	F
Case	Keenan	M
Jazmyne	Keene	F
Meryl	Keener	F
Nicola	Keeney	F
Windy	Keeton	F
Ashtyn	Kehoe	F
Meadow	Keil	F
Cal	Keim	M
Margarett	Keiser	F
Jacque	Keith	F
Ouida	Kell	F
Johnpaul	Kellar	M
Javion	Kelleher	M
Sabra	Keller	F
Shara	Kelley	F
Menachem	Kellner	M
Dasia	Kellogg	F
Eleni	Kellum	F
Brea	Kelly	F
Deion	Kelsey	M
Lynsey	Kelso	F
Lavinia	Kemp	F
Cydney	Kemper	F
Kevon	Kempf	M
Lyda	Kendall	F
Malakai	Kendrick	M
Torrey	Kennard	M
Shirlene	Kennedy	F
Ean	Kenney	M
Geralyn	Kenny	F
Anabella	Kent	F
Emogene	Kenyon	F
Camilo	Keough	M
Tresa	Kephart	F
Jamya	Kerley	F
Dori	Kern	F
Hosea	Kerns	M
Leslee	Kerr	F
Von	Kerrigan	M
Sarita	Kersey	F
Carleton	Kershaw	M
Laron	Kesler	M
Deandra	Kessler	F
Julieta	Kester	F
Lawerence	Ketchum	M
Shanon	Key	F
Alannah	Keyes	F
Wally	Keys	M
Rubie	Keyser	F
Dorinda	Khalil	F
Bishop	Khan	M
Caesar	Khoury	M
Vladimir	Kibler	M
Anjali	Kidd	F
Dorotha	Kidder	F
Norene	Kidwell	F
Maxim	Kiefer	M
Heidy	Kieffer	F
Vilma	Kiel	F
Adelynn	Kiernan	F
Casimir	Kight	M
Madisen	Kilby	F
Marcello	Kile	M
Alford	Kiley	M
Kacy	Kilgore	F
Wylie	Killian	M
Garett	Killingsworth	M
Nena	Killion	F
Cain	Kilmer	M
Nyasia	Kilpatrick	F
Destin	Kim	M
Briley	Kimball	F
Evans	Kimble	M
Chanelle	Kimbrell	F
Adelia	Kimbrough	F
Whitley	Kimmel	F
Jeromy	Kinard	M
Ilana	Kincaid	F
Killian	Kinder	M
Lafayette	Kindred	M
Darell	King	M
Brionna	Kingery	F
Margarito	Kingsbury	M
Nya	Kingsley	F
Zain	Kingston	M
Reilly	Kinney	F
Tegan	Kinser	F
Denton	Kinsey	M
Brittanie	Kipp	F
Casie	Kirby	F
Kenley	Kirchner	F
Jayna	Kirk	F
Lakeshia	Kirkland	F
Tobin	Kirkman	M
Kati	Kirkpatrick	F
Zina	Kirksey	F
Waymon	Kirkwood	M
Caleigh	Kirsch	F
Ileana	Kiser	F
Shad	Kish	M
Cailyn	Kissinger	F
Dallin	Kistler	M
Yehuda	Kitchen	M
Jaylyn	Kitchens	F
Donell	Kite	M
Nada	Kittle	F
Adilene	Kitts	F
Gearldine	Kizer	F
Norberto	Klatt	M
Alize	Klaus	F
Lashanda	Klein	F
Gil	Kline	M
Krystina	Kling	F
Lorin	Klinger	M
Campbell	Klotz	F
Jaren	Klug	M
Jesica	Knapp	F
Charli	Knecht	F
Ferne	Knight	F
Racquel	Knighton	F
Carleigh	Knoll	F
Janey	Knorr	F
Yahaira	Knott	F
Magaly	Knotts	F
Tye	Knowles	M
Kadin	Knowlton	M
Lorinda	Knox	F
Caitlynn	Knudsen	F
Taniya	Knudson	F
Marin	Knutson	F
Madaline	Ko	F
Shalonda	Koch	F
Zayne	Kocher	M
Sanaa	Koehler	F
Bernita	Koehn	F
Judd	Koenig	M
Ronna	Koerner	F
Nikhil	Koester	M
Erlinda	Kohl	F
Florene	Kohler	F
Hayleigh	Kohn	F
Santana	Kolb	F
Maxie	Koller	M
Tarah	Kong	F
Winnifred	Koon	F
Tayla	Koonce	F
Emmaline	Koons	F
Antione	Koontz	M
Dalila	Kopp	F
Santo	Korn	M
Aryan	Kornegay	M
Noor	Korte	F
Britt	Koski	M
Anisa	Koss	F
Brain	Koster	M
Cinda	Kovach	F
Keara	Kovacs	F
Rueben	Koval	M
Tyshawn	Kowal	M
Vergie	Kowalczyk	F
Jevon	Kowalski	M
Myranda	Kozak	F
Bethel	Kozlowski	F
Nathalia	Kraemer	F
Elizebeth	Kraft	F
Jalyn	Kramer	F
Reynold	Krantz	M
Mariyah	Kranz	F
Mustafa	Kratz	M
Arlette	Kraus	F
Mellisa	Krause	F
Christophe	Krauss	M
Tyesha	Krebs	F
Kasen	Kreider	M
Annelise	Kremer	F
Delton	Kress	M
Aundrea	Krieg	F
Giles	Krieger	M
Kalli	Kroeger	F
Glendon	Krohn	M
Deric	Kroll	M
Eugenio	Krueger	M
Lanie	Krug	F
Jesenia	Kruger	F
Farah	Kruse	F
Alyssia	Kubler-Ross	F
Jerimiah	Kucera	M
Tanika	Kuehl	F
Levon	Kuehn	M
Brandyn	Kuhl	M
Cleve	Kuhlman	M
Carin	Kuhn	F
Meyer	Kuhns	M
Rayne	Kulp	F
Arvin	Kumar	M
Lennie	Kunkel	F
Winford	Kunkle	M
Davian	Kuntz	M
Aydan	Kunz	M
Xochitl	Kuo	F
Ivanna	Kurth	F
Syed	Kurtz	M
Kaylene	Kushner	F
Roni	Kuykendall	F
Enrico	Kwan	M
Jeane	Kwiatkowski	F
Shanell	Kwok	F
Fermin	Kwon	M
Jaeden	Kwong	M
Celena	Kyle	F
Averi	La	F
Zaiden	LaBelle	M
Dickie	LaBonte	M
Ireland	LaBrue	F
Brannon	LaCombe	M
Kash	LaCroix	M
Carnell	LaFeuillande	M
Lucious	LaFrance	M
Jagger	LaGaisse	M
Ethelyn	LaLonde	F
Cherise	LaMaitre	F
Zona	LaMatry	F
Arnoldo	LaMont	M
Carolee	LaPierre	F
Jovanni	LaPlante	M
Grecia	LaPointe	F
Amare	LaPorte	M
Afton	LaRoche	F
Hernan	LaRose	M
China	LaRue	F
Stone	LaSance	M
Lavada	LaSart	F
Gavyn	LaVallee	M
Rasheed	Laboy	M
Jeramy	Lacey	M
Dedra	Lachance	F
Daisha	Lackey	F
Gisele	Lacy	F
Shiela	Ladd	F
Len	Ladner	M
Aliana	Lafferty	F
Mindi	Lafleur	F
Jessy	Lagunas	M
Myrtie	Lai	F
Almeda	Laing	F
Anneliese	Laird	F
Carie	Lake	F
Debrah	Lally	F
Alexandre	Lam	M
Elna	Lamar	F
Esta	Lamb	F
Jayceon	Lambert	M
Karri	Lamm	F
Jamir	Lammers	M
Anitra	Lampe	F
Iyana	Lampkin	F
Kendell	Lancaster	M
Laken	Lance	F
Galilea	Land	F
Zavier	Landa	M
Makaila	Landau	F
Hilario	Lander	M
Jaimee	Landeros	F
Ottis	Landers	M
Kyndall	Landes	F
Jerrica	Landis	F
Mechelle	Landon	F
Bristol	Landreth	F
Casper	Landrum	M
Adalberto	Landry	M
Anastacia	Lane	F
Georgene	Laney	F
Eleazar	Lang	M
Jaci	Langan	F
Alethea	Langdon	F
Shani	Lange	F
Hali	Langer	F
Jordy	Langford	M
Myrtice	Langley	F
Alida	Langlois	F
Jasen	Langston	M
Pricilla	Lanham	F
Desire	Lanier	F
Webster	Lankford	M
Edie	Lanning	F
Zula	Lantz	F
Estefany	Lanza	F
Cherrie	Lao	F
Eulalia	Lapp	F
Britni	Lara	F
Albin	Large	M
Dwaine	Larios	M
Keanu	Larkin	M
Cassondra	Larkins	F
Briella	Larocca	F
Kya	Larosa	F
Soraya	Larry	F
Keli	Larsen	F
Austyn	Larson	M
Melvyn	Lash	M
Sibyl	Lasher	F
Jeraldine	Lashley	F
Hadassah	Laskowski	F
Herlinda	Lassiter	F
Karim	Laster	M
Shoshana	Latham	F
Gearld	Lathrop	M
Farrell	Latimer	M
Hakeem	Latta	M
Velva	Lattimore	F
Chace	Lau	M
Trevin	Lauer	M
Kylah	Laughlin	F
Konner	Laurent	M
Wardell	Lavelle	M
Jere	Lavender	M
Clem	Lavigne	M
Denisha	Lavin	F
Jolynn	Lavoie	F
Migdalia	Law	F
Tyrus	Lawhorn	M
Gannon	Lawler	M
Zuri	Lawless	F
Elmira	Lawlor	F
Shanelle	Lawrence	F
Gaynell	Laws	F
Terrill	Lawson	M
Cristin	Lawton	F
Merton	Lay	M
Santa	Layman	F
Yisroel	Layne	M
Braulio	Layton	M
Jalynn	Lazar	F
Lita	Lazaro	F
Azaria	Lazarus	F
Oran	Lazo	M
Renea	Le	F
Estell	LeBerth	F
Dylon	LeCaire	M
Melton	LeCapitain	M
Raiden	LeClair	M
Vita	LeDow	F
Elianna	LeDuc	F
Melia	LeFevre	F
Delphia	LeFridge	F
Natali	LeGrand	F
Cambria	LeGras	F
Shasta	LeGrove	F
Lorne	LeJeune	M
Jeramiah	LeMaster	M
Kenyatta	LeMesurier	F
Deasia	LeMieux	F
Karsyn	LeMoine	F
Marylin	LeRoy	F
Melony	Lea	F
Marti	Leach	F
Crista	Leahy	F
Aditya	Leake	M
Luka	Leal	M
Samatha	Lear	F
Anjelica	Leary	F
Kendyl	Leatherman	F
Tawny	Leathers	F
Abelardo	Leatherwood	M
Darold	Leavitt	M
Del	Lebeau	M
Zenobia	Leblanc	F
Mordechai	Lebron	M
Roel	Ledbetter	M
Lianna	Ledesma	F
Catina	Ledet	F
Leana	Ledezma	F
Everardo	Ledford	M
Felice	Ledoux	F
Linette	Lee	F
Marcell	Leech	M
Chrissy	Leeper	F
Stephaine	Lees	F
Dedrick	Lefebvre	M
Lynwood	Leffler	M
Kirstie	Leger	F
Horacio	Legg	M
Kaylan	Legge-Bourke	F
Cherri	Leggett	F
Boris	Lehman	M
Benjiman	Lehmann	M
Laurene	Lehr	F
Allegra	Lei	F
Armond	Leigh	M
Janeth	Leighton	F
Kathaleen	Leija	F
Davonte	Leiva	M
Malka	Leland	F
Isreal	Lemay	M
Ladarius	Lemke	M
Jovany	Lemley	M
Lilla	Lemmon	F
Woody	Lemon	M
Ricki	Lemons	F
Malika	Lemos	F
Fonda	Lemus	F
Leesa	Lenhart	F
Rich	Lennon	M
Bowen	Lent	M
Cassius	Lentz	M
Jovanny	Lenz	M
Monet	Leo	F
Leeroy	Leon	M
Adrain	Leonard	M
Grayce	Leonardo	F
Sherryl	Leone	F
Blane	Leong	M
Carlyn	Leos	F
Nyah	Lepore	F
Julisa	Lerma	F
Karlene	Lerner	F
Malaya	Leslie	F
Loy	Lessard	M
Franchesca	Lester	F
Charlize	Letourneau	F
Demetra	Letourneau-Leblond	F
Adolphus	Lett	M
Jeremie	Leung	M
Richmond	Levan	M
Clarance	Levasseur	M
Justyn	Leverett	M
Infant	Levesque	M
Zaire	Levi	M
Jacinda	Levin	F
Jennings	Levine	M
Paulo	Levinson	M
Suzy	Levitt	F
Wes	Levy	M
Kasie	Lew	F
Ryne	Lewallen	M
Rina	Lewandowski	F
Verona	Lewin	F
Tawanda	Lewis	F
Immanuel	Ley	M
Eldora	Leyva	F
Timmothy	Li	M
Jaylan	LiConti	M
Crawford	Liang	M
Ocie	Liao	F
Barron	Libby	M
Iyanna	Liddell	F
Rowland	Lieberman	M
Cristine	Lien	F
Jammie	Liggett	F
Bilal	Light	M
Iman	Lightfoot	F
Bradyn	Lightner	M
Zainab	Ligon	F
Suzann	Liles	F
Taj	Lilley	M
Harlee	Lillie	F
Corwin	Lilly	M
Dannielle	Lim	F
Vernita	Lima	F
Neha	Limon	F
Tiera	Lin	F
Evelina	Linares	F
Sudie	Lincoln	F
Emani	Lind	F
Remy	Lindberg	M
Sherita	Lindeman	F
Alvie	Lindemann	M
Cleta	Linden	F
Henri	Linder	M
Holley	Lindgren	F
Chiara	Lindley	F
Slade	Lindner	M
Viridiana	Lindquist	F
Anisha	Lindsay	F
Dameon	Lindsey	M
Obie	Lindstrom	M
Emmalyn	Ling	F
Reymundo	Link	M
Tasia	Linn	F
Elian	Linton	M
Smith	Linville	M
Schuyler	Lippert	M
Carma	Lipscomb	F
Zahra	Lira	F
Alexys	Lister	F
Eda	Liston	F
Marleen	Litchfield	F
Lu	Little	F
Konnor	Littlefield	M
Estefani	Littlejohn	F
Risa	Littleton	F
Zeke	Litton	M
Priscila	Littrell	F
Stevan	Liu	M
Azalea	Lively	F
Chelsi	Livengood	F
Toya	Livingston	F
Audie	Lizarraga	M
Rana	Llamas	F
Tenley	Llewellyn	F
Dell	Lloyd	M
Vernie	Lo	F
Jocelyne	Lock	F
Tremaine	Lockard	M
Hermon	Locke	M
Elmore	Lockett	M
Jacqulyn	Lockhart	F
Jefferey	Locklear	M
Darrion	Lockwood	M
Jessa	Lodge	F
Josefa	Loeffler	F
Porsha	Loera	F
Bartholomew	Loftin	M
Krysten	Loftis	F
Theadore	Lofton	M
Jarrell	Loftus	M
Aydin	Logan	M
Bertrand	Loggins	M
Davida	Logsdon	F
Early	Logue	M
Lillianna	Lohman	F
Lailah	Lohr	F
Linus	Lomas	M
Luvenia	Lomax	F
Quiana	Lombard	F
Riya	Lombardi	F
Thor	Lombardo	M
Chante	Lomeli	F
Elicia	London	F
General	Long	M
Jordin	Longo	F
Hortencia	Longoria	F
Inga	Loomis	F
Calli	Looney	F
Corene	Loos	F
Aaden	Loper	M
Mikala	Lopes	F
Justen	Lopez	M
Yamilet	Lor	F
Gustav	Lora	M
Tabetha	Lord	F
Savion	Loredo	M
Blythe	Lorenz	F
Shreya	Lorenzo	F
Refugio	Lott	M
Kenisha	Loucks	F
Jaleel	Loudermilk	M
Audry	Louie	F
Katlynn	Louis	F
Larue	Lovato	F
Luana	Love	F
Soledad	Lovejoy	F
Brennon	Lovelace	M
Fredy	Loveland	M
Markell	Loveless	M
Markel	Lovell	M
Jasmyne	Lovett	F
Rian	Loving	M
Pinkie	Low	F
Oakley	Lowder	M
Delana	Lowe	F
Edsel	Lowell	M
Tawanna	Lower	F
Oswald	Lowery	M
Yolonda	Lowman	F
Dominque	Lowrey	F
Willian	Lowry	M
Jailyn	Loy	F
Blakely	Loya	F
Sharee	Loyd	F
Sherilyn	Loza	F
Reno	Lozada	M
Gaige	Lozano	M
Shavon	Lu	F
Lennon	Lucas	M
Barb	Luce	F
Kalen	Lucero	M
Patricio	Luciano	M
Barbie	Lucio	F
Howell	Luck	M
Kimberli	Luckett	F
Mirna	Luckey	F
Elzie	Ludwig	M
Lissa	Luevano	F
Niles	Lugo	M
Daxton	Lui	M
Memphis	Luis	M
Kindra	Lujan	F
Ayleen	Lukas	F
Cammie	Luke	F
Delfina	Luker	F
Mikael	Lum	M
Debi	Lumpkin	F
Shawnee	Luna	F
Page	Lund	F
Gisela	Lundberg	F
Symone	Lundgren	F
Kamilah	Lundquist	F
Mallorie	Lundy	F
Garnett	Lung	M
Aya	Lunn	F
Luigi	Lunsford	M
Jamia	Luo	F
Jerica	Luong	F
Vidal	Lupo	M
Evelyne	Lusk	F
Gaston	Lussier	M
Hobart	Luster	M
Prentice	Luther	M
Loyal	Luttrell	M
Verlin	Lutz	M
Dominga	Luu	F
Kristoffer	Lux	M
Liane	Ly	F
Elgin	Lykins	M
Kalia	Lyle	F
Meghann	Lyles	F
Yetta	Lyman	F
Marge	Lynch	F
Glory	Lynn	F
Tangela	Lyon	F
Sharen	Lyons	F
Ritchie	Lytle	M
Milena	Ma	F
Elayne	Maas	F
Ransom	Mabe	M
Reinaldo	Mabry	M
Jerad	MacAuliffe	M
Gigi	MacCarty	F
Henderson	MacCauley	M
Raylene	MacClaine	F
Yaakov	MacCleery	M
Ely	MacClelland	M
Montgomery	MacCleverty	M
Damarion	MacCloud	M
Lonzo	MacCray	M
Thomasina	MacCredie	F
Kyree	MacCue	M
Kayle	MacCurrach	F
Eldred	MacDonald	M
Hampton	MacFarlane	M
Violette	MacGregor	F
Alisia	MacKay	F
Claudie	MacKenzie	F
Denzil	MacKinley	M
Laylah	MacLea	F
Audrianna	MacLean	F
Laverna	MacLeod	F
Kamille	MacLucas	F
Kelby	MacMillan	M
Paityn	MacNeary	F
Dennie	MacPherson	M
Dillard	MacSporran	M
Joseluis	MacThomas	M
Herminia	MacWhirter	F
Johann	Macaluso	M
Lilyan	Macapagal-Arroyo	F
Wayland	Mace	M
Alexi	Macedo	F
Jered	Mach	M
Hasan	Machado	M
Bridger	Machuca	M
Erasmo	Macias	M
Alayah	Maciel	F
Nikia	Mack	F
Delanie	Mackey	F
Joselin	Mackie	F
Tremayne	Macklin	M
Alaysia	Macon	F
Maisie	Macy	F
Tarik	Madden	M
Alyvia	Maddox	F
Yousef	Maddux	M
Derwin	Mader	M
Adaline	Madera	F
Edson	Madigan	M
Kellee	Madison	F
Ameer	Madrid	M
Madden	Madrigal	M
Rachell	Madsen	F
Braedon	Maes	M
Gracelynn	Maestas	F
Tavon	Magallanes	M
Arian	Magana	M
Kyndal	Magdaleno	F
Arlin	Magee	M
Raeann	Maggard	F
Evon	Maggio	F
Gretta	Magill	F
Niya	Magnuson	F
Janiah	Maguire	F
Stefany	Mahaffey	F
Lorenza	Mahan	M
Kolten	Maher	M
Loran	Mahler	M
Phillis	Mahon	F
Gareth	Mahoney	M
Makai	Mai	M
Shianne	Maier	F
Ellyn	Main	F
Kalee	Majewski	F
Zaniyah	Major	F
Angelic	Majors	F
Ammon	Mak	M
Kaeden	Maki	M
Abrianna	Malave	F
Donal	Malcolm	M
Loriann	Maldonado	F
Alora	Malek	F
Keren	Maley	F
Suzie	Malik	F
Donta	Malinowski	M
Trystan	Mallard	M
Vonnie	Mallett	F
Yessica	Mallon	F
Langston	Mallory	M
Nels	Malloy	M
Odin	Malone	M
Debbra	Maloney	F
Audriana	Maloy	F
Keyshawn	Man	M
Everly	Manchester	F
Jelani	Mancilla	M
Christ	Mancini	M
Martez	Mancuso	M
Sherwin	Mandel	M
Ajay	Maness	M
Halley	Mangan	F
Rayan	Mangum	M
Gauge	Manion	M
Lino	Manis	M
Jackelyn	Manley	F
Tomeka	Mann	F
Lanita	Manning	F
Louvenia	Manns	F
Carlyle	Manriquez	M
Amado	Mansfield	M
Gibson	Manson	M
Charis	Mansour	F
Christel	Manuel	F
Haskell	Manzanares	M
Michal	Manzano	M
Nella	Manzo	F
Randel	Mapes	M
Willy	Maple	M
Deondre	Maples	M
Gaetano	Mapp	M
Charlette	Mar	F
Kirt	Marble	M
Melani	March	F
Jeniffer	Marchand	F
Sami	Marchant	M
Queenie	Marchese	F
Stetson	Marcotte	M
Kimberlie	Marcum	F
Loni	Marcus	F
Echo	Marek	F
Dempsey	Mares	M
Deneen	Margolis	F
Mel	Mariano	M
Dionna	Marin	F
Randa	Marinelli	F
Keyana	Marino	F
Jaquelin	Marion	F
Faustino	Mariscal	M
Jettie	Mark	F
Nydia	Marker	F
Nereida	Markey	F
Vinson	Markham	M
Lavonda	Markle	F
Leeanna	Markley	F
Duwayne	Markowitz	M
Brittny	Marks	F
Westin	Marler	M
Kiarra	Marley	F
Yamileth	Marlin	F
Gabe	Marlow	M
Samaria	Marlowe	F
Gaven	Maroney	M
Annaliese	Marotta	F
Arianne	Marquardt	F
Candida	Marques	F
Aleigha	Marquez	F
Dayne	Marquis	M
Adyson	Marr	F
Palma	Marra	F
Sal	Marrero	M
Georgetta	Marriott	F
Jasiah	Marron	M
Drucilla	Marroquin	F
Benjamen	Marrs	M
Bethanie	Mars	F
Desean	Marsden	M
Janene	Marsh	F
Journee	Marshall	F
Daniele	Marston	F
Loreen	Marte	F
Trae	Martel	M
Marko	Martell	M
Cyndi	Martens	F
Joetta	Martin	F
Joella	Martindale	F
Juwan	Martineau	M
Shmuel	Martinelli	M
Tierney	Martines	F
Florida	Martinez	F
Dequan	Martini	M
Alaya	Martino	F
Brien	Martins	M
Jacie	Martinson	F
Jennette	Marty	F
Anibal	Martz	M
Jacki	Marvin	F
Christofer	Marx	M
Montrell	Mashburn	M
Malorie	Mason	F
Rianna	Massa	F
Baxter	Massaro	M
Rosia	Massey	F
Rayshawn	Massie	M
Gray	Mast	M
Loyce	Masters	F
Manny	Masterson	M
Burke	Mata	M
Homero	Mateo	M
Tenisha	Matheny	F
Shlomo	Mather	M
Kathlene	Mathes	F
Kegan	Matheson	M
Colter	Mathew	M
Zandra	Mathews	F
Haden	Mathias	M
Corie	Mathieu	F
Janett	Mathis	F
Deonna	Mathison	F
Jerel	Matias	M
Willam	Matlock	M
Tiarra	Matney	F
Giavanna	Matos	F
Jai	Matson	M
Karleigh	Matsumoto	F
Amia	Matt	F
Clemente	Matta	M
Deedee	Mattern	F
Emersyn	Matteson	F
Courtland	Matthew	M
Lorelai	Matthews	F
Chantell	Mattingly	F
Gaylon	Mattison	M
Sanjuanita	Mattox	F
Mickie	Mattson	F
Watson	Matz	M
Angella	Mauldin	F
Kwame	Maupin	M
Wynona	Maurer	F
Analisa	Mauro	F
Loree	Maxey	F
Viva	Maxfield	F
Bayleigh	Maxson	F
Vincenza	Maxwell	F
Clarke	May	M
Aliah	Maya	F
Fisher	Mayberry	M
Carri	Mayer	F
Ardella	Mayers	F
Enos	Mayes	M
Isha	Mayfield	F
Karan	Mayhew	F
Rollie	Mayle	M
Simona	Maynard	F
Acacia	Maynor	F
Shanita	Mayo	F
Landry	Mayorga	M
Nate	Mays	M
Alek	Maze	M
Audrie	Mazur	F
Annamaria	Mazza	F
Yair	McAdams	M
Merrick	McAlister	M
Ariah	McAllister	F
Leonidas	McArdle	M
Laraine	McArthur	F
Maddie	McAtee	F
Alea	McAuliffe	F
Blayne	McAvoy	M
Delta	McBee	F
Cailin	McBride	F
Idell	McBroom	F
Darvin	McCabe	M
Leena	McCafferty	F
Joye	McCaffrey	F
Lenna	McCall	F
Juancarlos	McCallister	M
Naima	McCallum	F
Shanae	McCandless	F
Tyanna	McCann	F
Taniyah	McCants	F
Alain	McCarter	M
Sloan	McCarty	F
Augustin	McCaskill	M
Tracee	McCaslin	F
Carolyne	McClain	F
Kahlil	McClanahan	M
Elysia	McClary	F
Talan	McCleary	M
Cristofer	McClintock	M
Jame	McClinton	M
Javonte	McCloskey	M
Dillion	McCloud	M
Tillman	McClung	M
Emmit	McClure	M
Florian	McCluskey	M
Lilith	McComas	F
Lambert	McComb	M
Porfirio	McCombs	M
Sampson	McConnell	M
Jarett	McCool	M
Zulema	McCorkle	F
Andi	McCown	F
Annamae	McCoy	F
Johny	McCrary	M
Maile	McCraw	F
Kimberlyn	McCrea	F
Rolanda	McCready	F
Sheron	McCreary	F
Thurston	McCrory	M
Butch	McCue	M
Jericho	McCulley	M
Jaheim	McCulloch	M
Citlali	McCullough	F
Keanna	McCune	F
Merissa	McCurry	F
Charlton	McCutcheon	M
Conley	McDade	M
Kevan	McDaniel	M
Latrell	McDaniels	M
Torin	McDermott	M
Treyvon	McDevitt	M
Ethen	McDonough	M
Merlyn	McDougal	M
Rosaline	McDougall	F
Judge	McDowell	M
Jeremey	McDuffie	M
Altha	McEvoy	F
Price	McEwen	M
Omarion	McFadden	M
Billye	McFall	F
Cloe	McFarland	F
Zaid	McFarlane	M
Kyron	McFarlin	M
Myesha	McGarry	F
Cailey	McGehee	F
Maiya	McGhee	F
Alli	McGinley	F
Analise	McGinn	F
Rishi	McGinty	M
Isaak	McGough	M
Jaymie	McGowan	F
Les	McGrath	M
Sahara	McGraw	F
Dennise	McGregor	F
Devorah	McGrew	F
Magen	McGriff	F
Retta	McGuinness	F
Sedrick	McGuire	M
Jarret	McHale	M
Phylis	McHenry	F
Erinn	McInerney	F
Kayson	McInnis	M
Keyonna	McIntire	F
Creighton	McIntosh	M
Sana	McIntyre	F
Kiya	McIver	F
Suellen	McKay	F
Torrance	McKean	M
Guido	McKee	M
Eugenie	McKeever	F
Demetri	McKelvey	M
Karena	McKenney	F
Tyquan	McKeon	M
Mylee	McKeown	F
Ryley	McKibben	M
Azucena	McKinnon	F
Miguelangel	McKnight	M
Otho	McKoy	M
Werner	McLane	M
Destany	McLaren	F
Ceasar	McLaughlin	M
Kathern	McLaurin	F
Braylee	McLean	F
Jeramie	McLellan	M
Makala	McLemore	F
Elin	McLendon	F
Jaslyn	McLeod	F
Jordynn	McLoughlin	F
Kaelynn	McMahan	F
Willia	McMahon	F
Yulissa	McManus	F
Arman	McMaster	M
Joseline	McMichael	F
Alonza	McMillan	M
Charisma	McMillen	F
Rachele	McMillian	F
Sheyla	McMillin	F
Wynter	McMinn	F
Amar	McMullen	M
Llewellyn	McMullin	M
Marielle	McMurray	F
Britta	McNabb	F
Emalee	McNair	F
Ema	McNally	F
Ariane	McNamee	F
Elba	McNeal	F
Misha	McNeely	F
Ciarra	McNeil	F
Nancie	McNew	F
Manda	McNutt	F
Spring	McPhail	F
Marylyn	McPherson	F
Kera	McQuade	F
Beckham	McQueen	M
Marylee	McReynolds	F
Yitzchok	McShane	M
Elenora	McSwain	F
Lonna	McVay	F
Janaya	McVey	F
Alix	McWhorter	F
Brittaney	McWilliams	F
Janetta	Mcafee	F
Kalynn	Mccain	F
Aarav	Mccarthy	M
Brogan	Mccartney	M
Larisa	Mccauley	F
Obed	Mcclellan	M
Babette	Mcclelland	F
Rosamond	Mcclendon	F
Buffy	Mccollum	F
Noa	Mccord	F
Dajuan	Mccormack	M
Holland	Mccormick	F
Samiyah	Mccracken	F
Kailynn	Mccray	F
Sofie	Mccurdy	F
Tyrel	Mcdonald	M
Shimon	Mcdonnell	M
Auston	Mcelroy	M
Larae	Mcgee	F
Kenji	Mcgill	M
Arnetta	Mcginnis	F
Leda	Mcgovern	F
Malina	Mchugh	F
Eamon	Mckenna	M
Jaycob	Mckenzie	M
Domenica	Mckinley	F
Amparo	Mckinney	F
Leighann	Mclain	F
Michale	Mcnamara	M
Teresita	Mcneill	F
Honey	Mcnulty	F
Pranav	Mcrae	M
Cy	Meacham	M
Rebecka	Mead	F
Timmie	Meade	M
Nilda	Meador	F
Gerson	Meadows	M
Tamie	Meagher	F
Jovita	Means	F
Remi	Mears	F
Izabelle	Medeiros	F
Nicklaus	Medellin	M
Ronni	Medina	F
Caprice	Medley	F
Newell	Medlin	M
Marni	Medlock	F
Evert	Medrano	M
Aiyanna	Meehan	F
Rahul	Meek	M
Jaxton	Meeker	M
Konrad	Meeks	M
Roxy	Mehta	F
Delisa	Mei	F
Lovell	Meier	M
Analia	Meister	F
Geovanni	Mejia	M
Bronwyn	Melancon	F
Javan	Melanson	M
Trudi	Melcher	F
Diya	Melchor	F
Berneice	Melendez	F
Lili	Melgar	F
Mahogany	Mello	F
Chassidy	Mellon	F
Neta	Mellott	F
Dasha	Melo	F
Johnetta	Melson	F
Lylah	Melton	F
Ezell	Melvin	M
Keyanna	Mena	F
Aubrianna	Menard	F
Abdiel	Menchaca	M
Janee	Mendenhall	F
Cristi	Mendes	F
Magali	Mendez	F
Ignatius	Mendiola	M
Lamonte	Mendoza	M
Vienna	Menefee	F
Chas	Menendez	M
Karolina	Meneses	F
Montserrat	Menjivar	F
Robb	Menke	M
Malena	Meraz	F
Isidore	Mercado	M
Jonatan	Mercer	M
Katherin	Merchant	F
Mirian	Mercier	F
Caron	Mercurio	F
Jacinta	Meredith	F
Kaytlin	Merino	F
Kierstin	Merkel	F
Lesia	Merrell	F
Marilou	Merrick	F
Callum	Merrill	M
Elayna	Merriman	F
Davie	Merritt	M
Machelle	Merriweather	F
Bobbye	Mertz	F
Merri	Merz	F
Tanna	Mesa	F
Allyn	Messenger	M
Jenae	Messer	F
Lathan	Messick	M
Kathyrn	Messier	F
Nicholaus	Messina	M
Vannessa	Messner	F
Danya	Metcalf	F
Domenico	Metcalfe	M
Dwane	Metz	M
Harlie	Metzger	F
Lexis	Metzler	F
Tripp	Meyer	M
Ria	Meyers	F
Pamella	Meza	F
Callen	Miceli	M
Jacquelyne	Michael	F
Zaira	Michaels	F
Sari	Michalski	F
Darrian	Michaud	M
Nickie	Michel	F
Ashlea	Michels	F
Aubri	Mick	F
Alise	Mickelson	F
Madie	Mickens	F
Kora	Mickey	F
Jacy	Middlebrooks	F
Kecia	Middleton	F
Charolette	Midkiff	F
Avi	Mielke	M
Godfrey	Miguel	M
Salomon	Milam	M
Romaine	Milan	F
Geno	Milano	M
Edmundo	Milburn	M
Deontae	Miles	M
Neoma	Miley	F
Trudie	Mill	F
Bernardine	Millan	F
Chip	Millar	M
Kamren	Millard	M
Tito	Miller	M
Vallie	Milligan	F
Codey	Milliken	M
Amador	Mills	M
Codi	Millsap	F
Jonelle	Milne	F
Brieanna	Milner	F
Alisson	Milton	F
Collins	Mims	M
Autum	Min	F
Neveah	Mincey	F
Christoper	Miner	M
Jones	Ming	M
Ena	Mingo	F
Lex	Mink	M
Haydee	Minnich	F
Latesha	Minnick	F
Madelaine	Minor	F
Rileigh	Minter	F
Sylas	Minton	M
Jaycie	Mintz	F
Natosha	Miracle	F
Elwyn	Miramontes	M
Jaxen	Miranda	M
Laurette	Mireles	F
Jayvon	Mitchel	M
Kentrell	Mitchell	M
Stephania	Mitchem	F
Tomasa	Mix	F
Kenan	Mixon	M
Krystin	Mize	F
Levy	Mizell	M
Shonna	Moats	F
Susann	Mobley	F
Breeanna	Mock	F
Elly	Moe	F
Vianey	Moeller	F
Charleigh	Moen	F
Ennis	Moffatt	M
Azariah	Moffett	F
Magdalen	Moffitt	F
Murry	Mohamed	M
Ronin	Mohammed	M
Eben	Mohan	M
Hedwig	Mohler	F
Ridge	Mohr	M
Vinnie	Mojica	F
Jessalyn	Molina	F
Kelcie	Moll	F
Rosevelt	Molloy	M
Rolf	Molnar	M
Yara	Monaco	F
Angelena	Monaghan	F
Jodee	Monahan	F
Julieann	Moncada	F
Khadija	Moncrief	F
Arvid	Monday	M
Dilan	Mondragon	M
Baylie	Money	F
Adah	Monge	F
Salome	Moniz	F
Braelynn	Monk	F
Elina	Monreal	F
Leeanne	Monroe	F
Letty	Monroy	F
Rowdy	Monson	M
Ansel	Montague	M
Carletta	Montalvo	F
Zaida	Montana	F
Chelsy	Montanez	F
Davey	Montano	M
Odalys	Monte	F
Cloyd	Monteiro	M
Garold	Montelongo	M
Janiece	Montemayor	F
Mozell	Montenegro	F
Sylvan	Montero	M
Trish	Montes	F
Thornton	Montez	M
Jalissa	Montgomery	F
Yael	Montiel	F
Freeda	Montoya	F
Keturah	Monzon	F
Shaelyn	Moody	F
Jamin	Moon	M
Mikal	Mooney	M
Abbygail	Moore	F
Aislinn	Moorehead	F
Sequoia	Moorer	F
Elease	Moorhead	F
Luiz	Moorman	M
Paolo	Mora	M
Stormie	Morales	F
Vernetta	Moralez	F
Jenell	Moran	F
Rashaad	Moreau	M
Yandel	Morehead	M
Lawana	Morehouse	F
Jaleesa	Moreira	F
Bulah	Morel	F
Graydon	Moreland	M
Kensley	Morelli	F
Karah	Moreno	F
Ilona	Morey	F
Trenten	Morgan	M
Mariella	Moriarty	F
Princeton	Morin	M
Catarina	Moritz	F
Armida	Morley	F
Shandra	Morrell	F
Yanira	Morrill	F
Dreama	Morris	F
Bradlee	Morrison	M
Arlan	Morrissey	M
Canaan	Morrow	M
Delila	Morse	F
Makenzi	Mortensen	F
Milissa	Mortimer	F
Rafaela	Morton	F
Hilma	Mosby	F
Sebastien	Moseley	M
Keona	Moser	F
Tamiko	Moses	F
Lilyanna	Mosher	F
Dyllan	Mosier	M
Patric	Moskowitz	M
Avraham	Mosley	M
Harlow	Mosqueda	F
Florentino	Moss	M
Jonny	Mota	M
Rosalina	Motley	F
Candyce	Mott	F
Candie	Moua	F
Carisa	Moulton	F
Elora	Mount	F
Wyman	Mouton	M
Krish	Mowery	M
Kelsy	Mowry	F
Amarion	Moxley	M
Cael	Moy	M
Velvet	Moya	F
Torrence	Moye	M
Windell	Moyer	M
Amiah	Moyers	F
Debbi	Mudd	F
Lucky	Mueller	M
Leopold	Muhammad	M
Quenton	Muir	M
Sabastian	Mulcahy	M
Urban	Mulder	M
Jacobi	Mulholland	M
Aidyn	Mulkey	M
Mallie	Mull	F
Alanah	Mullaney	F
Oneal	Mullen	M
Brookelyn	Muller	F
Angeles	Mulligan	F
Rashida	Mullin	F
Gerold	Mullinax	M
Promise	Mullins	F
Andie	Mullis	F
Jemma	Mumford	F
Kymberly	Muncy	F
Nailah	Mundy	F
Clovis	Munger	M
Raynard	Munguia	M
Pernell	Muniz	M
Luc	Munn	M
Malaki	Munoz	M
Teodoro	Munro	M
Eveline	Munroe	F
Jordana	Munson	F
Darrien	Murdock	M
Florencio	Murillo	M
Azul	Muro	F
Jakobe	Murphy	M
Linden	Murray	M
Sherron	Murrell	F
Clarisa	Murry	F
Dejah	Muse	F
Jael	Musgrave	F
Marceline	Musgrove	F
Deeann	Music	F
Shavonne	Musick	F
Genna	Musselman	F
Talitha	Musser	F
Blaire	Muth	F
Gladis	Myer	F
Marcelina	Myers	F
Fransisco	Myles	M
Gentry	Myrick	M
Jory	Nabors	M
Armon	Nadeau	M
Arvilla	Nagel	F
Shaunna	Nagle	F
Eusebio	Nagy	M
Mikhail	Nail	M
Meggan	Najera	F
Willene	Nakamura	F
Cleon	Nall	M
Damarcus	Nalley	M
Ara	Nam	F
Milana	Nance	F
Giada	Napier	F
Annis	Napoli	F
Apryl	Napolitano	F
Derrek	Naquin	M
Devlin	Naranjo	M
Eartha	Narvaez	F
Nakita	Nash	F
Ossie	Nason	F
Randle	Natale	M
Abrielle	Nathan	F
Norwood	Nation	M
Kalea	Naughton	F
Nalani	Nava	F
Spenser	Navarrete	M
Santina	Navarro	F
Olympia	Nave	F
Rosann	Naylor	F
Maxx	Nazario	M
Osbaldo	Neal	M
Aviana	Neary	F
Isadora	Needham	F
Nichol	Neel	F
Meranda	Neeley	F
Avah	Neely	F
Tonie	Neese	F
Arley	Neff	M
Briar	Negrete	M
Jenessa	Negron	F
Ayaan	Neighbors	M
Jovanna	Neil	F
Adison	Neill	F
Naya	Neilson	F
Antonella	Nelms	F
Rudolf	Nelsen	M
Mirella	Nelson	F
Dionte	Nemeth	M
Haily	Neri	F
Octavius	Nesbit	M
Torri	Nesbitt	F
Tamala	Nesmith	F
Jenniffer	Ness	F
Kaylea	Nester	F
Aedan	Nestor	M
Daija	Nettles	F
Deanthony	Neubauer	M
Durward	Neuman	M
Honesty	Neumann	F
Rojelio	Nevarez	M
Isac	Neves	M
Drusilla	Neville	F
Mohamad	Nevins	M
Arnav	New	M
Latia	Newberry	F
Ivey	Newby	F
Terrel	Newcomb	M
Dorine	Newcomer	F
Talisha	Newell	F
Jermiah	Newhouse	M
Donato	Newkirk	M
Trayvon	Newland	M
Calla	Newman	F
Gardner	Newport	M
Farris	Newsom	M
Nils	Newsome	M
Gian	Newson	M
Halee	Newton	F
Madelyne	Nez	F
Shawnna	Ng	F
Zakiya	Ngo	F
Shawanda	Nguyen	F
Beckie	Nicely	F
Rance	Nicholas	M
Rashaun	Nicholls	M
Wayman	Nichols	M
Devonta	Nicholson	M
Freya	Nickel	F
Tiesha	Nickell	F
Maliah	Nickels	F
Corliss	Nickerson	F
Archibald	Nicol	M
Raoul	Nicolas	M
Aura	Nielsen	F
Kyara	Nielson	F
Kyrie	Nieman	F
Cris	Niemeyer	M
Mercedez	Niemi	F
Kieth	Nieto	M
Aminah	Nieves	F
Kyson	Nigro	M
Arie	Niles	F
Christena	Nino	F
Kingsley	Nissen	M
Matilde	Nix	F
Americo	Nixon	M
Jeni	Noah	F
Flynn	Noble	M
Izayah	Nobles	M
Nisha	Noe	F
Dakotah	Noel	M
Nevada	Nolan	F
Samiya	Noland	F
Zita	Nolasco	F
Jaya	Nolen	F
Brittnee	Noll	F
Heber	Nolte	M
Sid	Noonan	M
Philippe	Nord	M
Lianne	Nordstrom	F
Zariyah	Noriega	F
Casen	Norman	M
Keyona	Norris	F
Stoney	North	M
Aleshia	Northcutt	F
Tamatha	Northrup	F
Claribel	Norton	F
Lilli	Norwood	F
Demetrio	Novak	M
Jaret	Novotny	M
Renato	Nowak	M
Dalilah	Nowell	F
Shaila	Nowicki	F
Georgine	Nowlin	F
Delora	Noyes	F
Aleisha	Nugent	F
Signe	Null	F
Marlie	Nunes	F
Minna	Nunez	F
Pearle	Nunley	F
Randee	Nunn	F
Oral	Nuno	M
Montez	Nutt	M
Rutha	Nutter	F
Bernetta	Nye	F
Laine	O'Brien	F
Veronika	O'Briens	F
Torey	O'Casey	M
Bethann	O'Connell	F
Kael	O'Connor	M
Javen	O'Donnell	M
Haiden	O'Flaverty	M
Tavares	O'Grady	M
Demarion	O'Hara	M
Mackenna	O'Hegarty	F
Trevion	O'Hore	M
Brookelynn	O'Keefe	F
Rochel	O'Laverty	F
Tomika	O'Leary	F
Lluvia	O'Malley	F
Saylor	O'Mara	F
Tennie	O'Meara	F
Arne	O'Neill	M
Joeseph	O'Rahilly	M
Sylvie	O'Reilly	F
Tobi	O'Riada	F
Izabel	O'Rourke	F
Sherrell	O'Shea	F
Torrie	O'Sullivan	F
Renaldo	O'Toole	M
Flavio	Oakes	M
Jailene	Oakley	F
Terance	Oaks	M
Burnell	Oates	M
Gracyn	Oberg	F
Myriam	Obregon	F
Rand	Obryan	M
Lise	Ocampo	F
Nile	Ocasio	M
Sigmund	Ochoa	M
Esequiel	Ochs	M
Harlen	Odell	M
Marlana	Oden	F
Isobel	Odom	F
Sigrid	Ogden	F
Akilah	Ogle	F
Furman	Oglesby	M
Emeline	Ogletree	F
Velia	Oh	F
Becca	Ohare	F
Christianna	Ojeda	F
Chyanne	Oldham	F
Johannah	Olds	F
Vena	Olguin	F
Denita	Olin	F
Jamiya	Olinger	F
Avalon	Oliphant	F
Janina	Oliva	F
Nikko	Olivares	M
Anamaria	Olivarez	F
Lamarr	Olivas	M
Magan	Olive	F
Adamaris	Oliveira	F
Amit	Oliver	M
Kenyetta	Olivera	F
Destinie	Olivier	F
Maricruz	Olivo	F
Grey	Olmos	M
Kiah	Olmstead	F
Jedediah	Olsen	M
Regena	Olson	F
Corban	Olszewski	M
Magda	Olvera	F
Payten	Omar	F
Laquisha	Oneal	F
Karsten	Oneil	M
Thiago	Ong	M
Arlena	Ontiveros	F
Anthoney	Oquendo	M
Enedina	Oquinn	F
Rosalba	Orcutt	F
Kayce	Ordaz	F
Karleen	Ordonez	F
Zada	Orellana	F
Evin	Orlando	M
Ryanne	Ornelas	F
Sandie	Orona	F
Joshuah	Oropeza	M
Nechama	Orosco	F
Job	Orozco	M
Chanell	Orr	F
Franz	Orta	M
Julee	Ortega	F
Lavell	Orth	M
Elexis	Ortiz	F
Juniper	Ortiz-Magro	F
Torie	Orton	F
Alishia	Osborn	F
Lashay	Osborne	F
Deane	Osburn	M
Kye	Osgood	M
Lorretta	Osman	F
Ananya	Osorio	F
Kalina	Osteen	F
Kandis	Oster	F
Nixon	Ostrander	M
Taisha	Ostrowski	F
Blas	Osuna	M
Devona	Oswald	F
Gerrit	Oswalt	M
Melynda	Otero	F
Karisa	Otis	F
Zev	Ott	M
Keesha	Otte	F
Aditi	Otto	F
Soleil	Ouellette	F
Kamya	Ousley	F
Katalina	Outlaw	F
Rayden	Ovalle	M
Ever	Overby	M
Jaydin	Overman	M
Jameel	Overstreet	M
Ellison	Overton	F
Nallely	Oviedo	F
Latoria	Owen	F
Sameer	Owens	M
Treyton	Owings	M
Pascual	Oxendine	M
Durwood	Oxford	M
Enola	Oxley	F
Karoline	Ozuna	F
Ludie	Pabon	F
Rozella	Pace	F
Shaneka	Pacheco	F
Alessia	Pack	F
Domonic	Packard	M
Heavenly	Packer	F
Jamee	Paddock	F
Mandie	Padgett	F
Genie	Padilla	F
Magnus	Padron	M
Stafford	Paez	M
Coleton	Pagan	M
Jaslene	Pagano	F
Marna	Page	F
Pia	Pagel	F
Silvio	Pahl	M
Franky	Paige	M
Esme	Paine	F
Jolee	Painter	F
Lamarcus	Pak	M
Mykel	Palacio	M
Alliyah	Palacios	F
Kairi	Palermo	F
Sirena	Palm	F
Yarely	Palma	F
Jenise	Palmer	F
Leamon	Palmer-Tomkinson	M
Oriana	Palmieri	F
Saira	Palomares	F
Makaylah	Palomino	F
Jazzlyn	Palomo	F
Idalia	Palumbo	F
Vincente	Pan	M
Christeen	Pang	F
Sanai	Paniagua	F
Prentiss	Pannell	M
Tyla	Pantoja	F
Pandora	Papa	F
Storm	Pape	M
Capri	Pappas	F
Dacia	Paquette	F
Nolen	Parada	M
Yoel	Paradis	M
Mayte	Pardo	F
Jermey	Pardue	M
Harleigh	Paredes	F
Wm	Parent	M
Martine	Parham	F
Aleksander	Parikh	M
Brion	Paris	M
Jacinto	Parish	M
Audree	Parisi	F
Geronimo	Park	M
Kit	Parke	M
Deisy	Parker	F
Kennard	Parkhurst	M
Elois	Parkinson	F
Brandin	Parks	M
Ebonie	Parmer	F
Sharita	Parnell	F
Shantelle	Parr	F
Sindy	Parra	F
Ardell	Parris	F
Elie	Parrish	M
Damari	Parrott	M
Daryle	Parry	M
Merrie	Parsley	F
Phebe	Parson	F
Clemmie	Parsons	F
Hyrum	Partida	M
Sharyl	Partin	F
Cristen	Parton	F
Natashia	Partridge	F
Sapphire	Paschal	F
Anish	Paschall	M
Kymani	Pascual	M
Cheryll	Pass	F
Harrell	Passmore	M
Jarell	Pastor	M
Madelene	Pate	F
Emmeline	Patel	F
Kloe	Paterson	F
Meridith	Patino	F
Regenia	Patrick	F
Madelin	Patten	F
Reatha	Patterson	F
Micki	Pattison	F
Kalani	Patton	F
Kiesha	Paul	F
Laina	Pauley	F
Lakia	Paulino	F
Dariel	Paulk	M
Lawrance	Paulsen	M
Renard	Paulson	M
Ravi	Paulus	M
Rondell	Pawlowski	M
Brynna	Paxton	F
Kady	Payan	F
Verdie	Payne	F
Dashaun	Payton	M
Ariyana	Paz	F
Crosby	Peabody	M
Dakoda	Peace	M
Nidia	Peach	F
Shedrick	Peacock	M
Vivianna	Peak	F
Hansel	Peake	M
Ishaan	Pearce	M
Marleigh	Pearl	F
Daylon	Pearsall	M
Josselyn	Pearson	F
Dawne	Pease	F
Mahala	Peavy	F
Blossom	Peck	F
Aubry	Peckham	F
Kyan	Peden	M
Ludwig	Pedersen	M
Odette	Pederson	F
Addilyn	Pedigo	F
Danilo	Pedraza	M
Gorge	Pedro	M
Rayburn	Pedroza	M
Anselmo	Peebles	M
Malvin	Peek	M
Ailyn	Peel	F
Versie	Peele	F
Clive	Peeler	M
Curley	Peeples	M
Lennox	Peery	M
West	Pelayo	M
Raya	Pelkey	F
Arvil	Pell	M
Joslynn	Pellegrino	F
Kailani	Pelletier	F
Lavera	Peltier	F
Makhi	Pelton	M
Allana	Pemberton	F
Earlean	Pena	F
Welton	Penaloza	M
Keelan	Pence	M
Sharleen	Pender	F
Alona	Pendergrass	F
Doretta	Pendleton	F
Arla	Peng	F
Crissy	Penn	F
Caydence	Pennell	F
Kristel	Penner	F
Samia	Penney	F
Carsen	Pennington	M
Merl	Penny	M
Zeb	Penrod	M
Angelika	Peoples	F
Gaylene	Pepe	F
Katya	Pepin	F
Tanja	Pepper	F
Reginal	Peppers	M
Sena	Perales	F
Fausto	Peralta	M
Esau	Perdomo	M
Huston	Perdue	M
Kaytlyn	Perea	F
Maite	Pereira	F
Tamya	Peres	F
Vester	Perez	M
Doran	Perkins	M
Penni	Perreault	F
Armin	Perri	M
Kanisha	Perrin	F
Shaniyah	Perrine	F
Jaquelyn	Perron	F
Makiya	Perrone	F
Tavion	Perry	M
Anjanette	Perryman	F
Mayson	Persaud	M
Paislee	Persinger	F
Rilla	Person	F
Demetrios	Pete	M
Jacobo	Peter	M
Iain	Peterman	M
Jaclynn	Peters	F
Jadiel	Petersen	M
Glinda	Peterson	F
Ammie	Petit	F
Kaelin	Petrie	F
Lanae	Petro	F
Zaniya	Petry	F
Gennie	Pettigrew	F
Parrish	Pettis	M
Jania	Pettit	F
Antonina	Pettus	F
Jennah	Pettway	F
Shawnda	Petty	F
Qiana	Peyton	F
Steffanie	Pfaff	F
Amethyst	Pfeffer	F
Jamiyah	Pfeifer	F
Cathi	Pfeiffer	F
Venice	Pfister	F
Keandre	Pham	M
Tomi	Phan	F
Margaretta	Phelan	F
Terell	Phelps	M
Washington	Phifer	M
Jethro	Philip	M
Naoma	Philips	F
Ellery	Phillip	F
Laniya	Phillips	F
Odie	Philpot	M
Laurine	Phipps	F
Kaili	Phung	F
Adelaida	Piatt	F
Adia	Piazza	F
Mammie	Picard	F
Pauletta	Pichardo	F
Liv	Pickard	F
Shivani	Pickens	F
Tai	Pickering	M
Creed	Pickett	M
Alvera	Pieper	F
Fatimah	Pierce	F
Verl	Pierre	M
Wren	Pierson	F
Stefano	Pigg	M
Adin	Pike	M
Kynlee	Pilcher	F
Codie	Pilgrim	M
Dariana	Pilkington	F
Becki	Pimentel	F
Wellington	Pina	M
Allysa	Pinckney	F
Christos	Pine	M
Larhonda	Pineda	F
Ruthanne	Pinedo	F
Keana	Pinkerton	F
Tammara	Pinkney	F
Elan	Pinkston	M
Tyana	Pino	F
Dezmond	Pinon	M
Taina	Pinson	F
Devontae	Pinto	M
Avianna	Piotrowski	F
Launa	Piper	F
Bryton	Pipkin	M
Danyell	Pippin	F
Elvina	Pires	F
Anette	Pirtle	F
Jamon	Pisano	M
Wanita	Pitcher	F
Maida	Pitman	F
Mica	Pitre	F
Danyel	Pitt	F
Dontrell	Pittman	M
Madysen	Pitts	F
Dixon	Pizarro	M
Ania	Place	F
Janai	Plank	F
Kerstin	Plant	F
Scarlette	Plante	F
Julienne	Plascencia	F
Kadyn	Platt	M
Brie	Plaza	F
Kamal	Pleasant	M
Mabelle	Plumb	F
Keily	Plummer	F
Roddy	Plunkett	M
Siera	Poe	F
Baylor	Poff	M
Caterina	Pogue	F
Golden	Pohl	M
Makiyah	Poindexter	F
Markita	Pointer	F
Rashard	Poirier	M
Dayanna	Polanco	F
Lera	Poland	F
Nickole	Poling	F
Dustyn	Polk	M
Elvie	Pollack	F
Juston	Pollard	M
Deante	Polley	M
Delicia	Pollock	F
Sharif	Pomeroy	M
Aniah	Ponce	F
Coreen	Pond	F
Olan	Ponder	M
Bryleigh	Pool	F
Jhon	Poole	M
Kenney	Poore	M
Keller	Pope	M
Jovon	Popp	M
Demetris	Porras	M
Keziah	Porter	F
Kristiana	Porterfield	F
Makaela	Portillo	F
Genoveva	Posada	F
Jorja	Posey	F
Kittie	Post	F
Betsey	Poston	F
Kaleah	Poteet	F
Camelia	Potter	F
Drema	Potts	F
Rilee	Poulin	F
Arleth	Poulos	F
Jocelin	Pounds	F
Denae	Powell	F
Robinson	Power	M
Legend	Powers	M
Rami	Poynter	M
Raylee	Prado	F
Rebeka	Prasad	F
Rosaura	Prater	F
Nakisha	Prather	F
Alois	Pratt	M
Gizelle	Preciado	F
Rock	Prendergast	M
Celestino	Prentice	M
Klarissa	Prescott	F
Waneta	Presley	F
Geary	Pressley	M
Micayla	Preston	F
Rosio	Prewitt	F
Cielo	Price	F
Yaneli	Prichard	F
Favian	Priddy	M
Melodee	Pride	F
Cornelious	Pridgen	M
Kadie	Priest	F
Odalis	Prieto	F
Jakub	Prince	M
Aysha	Pringle	F
Jonell	Prior	F
Amin	Pritchard	M
Mykayla	Pritchett	F
Rosana	Probst	F
Sahil	Proctor	M
Johna	Proffitt	F
Leobardo	Propst	M
Lyra	Prosser	F
Micky	Proulx	M
Alverta	Provost	F
Dimple	Pruett	F
Hurley	Pruitt	M
Rexford	Pryor	M
Dhruv	Puckett	M
Miesha	Puente	F
Sabine	Puentes	F
Lawton	Puga	M
Modesto	Pugh	M
Yuri	Pugliese	F
Davy	Pulido	M
Lizet	Pullen	F
Aviva	Pulley	F
Chadd	Pulliam	M
Marely	Purcell	F
Olaf	Purdy	M
Ninfa	Purnell	F
Najee	Purvis	M
Bodie	Puryear	M
Maury	Putman	M
Tionna	Putnam	F
Jason	Pyeron	M
Tonda	Pyle	F
Glynda	Pyles	F
Hazle	Quach	F
Jeanene	Qualls	F
Jersey	Quan	F
Odelia	Quarles	F
Arch	Queen	M
Canyon	Quesada	M
Lenwood	Quevedo	M
Macario	Quezada	M
Zenaida	Quick	F
Anessa	Quigley	F
Isa	Quiles	F
Bell	Quillen	F
Sammuel	Quimby	M
Daylen	Quinlan	M
Lacee	Quinn	F
Lazarus	Quinones	M
Dorthea	Quinonez	F
Lexy	Quintana	F
Deonta	Quintanilla	M
Kavin	Quintero	M
Daina	Quirk	F
Citlaly	Quiroga	F
Gerhard	Quiroz	M
Avrohom	Qureshi	M
Leela	Raab	F
Phyliss	Rabe	F
Roby	Raber	M
Angelyn	Raby	F
Myrle	Race	F
Noelani	Racine	F
Hildred	Rackley	F
Ismail	Radcliff	M
Jeremias	Radcliffe	M
Maceo	Rader	M
Martell	Radford	M
Lindell	Radke	M
Jaydan	Radtke	M
Jerrel	Rae	M
Jalil	Rafferty	M
Aram	Ragan	M
Ethyl	Rager	F
Kiel	Ragland	M
Marquel	Ragsdale	M
Samya	Rahman	F
Cassaundra	Rahn	F
Tahj	Raines	M
Shaquita	Rainey	F
Yancy	Rains	M
Shona	Rainwater	F
Tuesday	Raley	F
Urijah	Ralph	M
Libbie	Ralston	F
Tiffiny	Rambo	F
Meri	Ramey	F
Simran	Ramires	F
Yusef	Ramirez	M
Yuridia	Ramon	F
Carman	Ramos	F
Lawanna	Ramsay	F
Leilah	Ramsey	F
Nikolaus	Rand	M
Jacqualine	Randall	F
Broc	Randazzo	M
Phylicia	Randle	F
Merlene	Randolph	F
Aryn	Raney	F
Baltazar	Rangel	M
Laniyah	Rankin	F
Norval	Ransom	M
Tarsha	Rao	F
Ferris	Raper	M
Garvin	Rapp	M
Lachelle	Rascon	F
Adelbert	Rash	M
Filiberto	Rashid	M
Neel	Rasmussen	M
Estel	Ratcliff	M
Jeb	Rath	M
Korina	Rathbun	F
Leslye	Ratliff	F
Ranae	Rau	F
Bjorn	Rauch	M
Kerwin	Rausch	M
Brigham	Rawlings	M
Daysha	Rawlins	F
Kadeem	Rawls	M
Kodi	Rawson	F
Nayely	Ray	F
Romina	Raya	F
Aleksandra	Rayburn	F
Lezlie	Rayford	F
Alethia	Raymer	F
Ayah	Raymond	F
Maryanna	Raynor	F
Carlin	Razo	M
Tashia	Rea	F
Ernst	Read	M
Jaedyn	Ready	F
Merna	Reagan	F
Ani	Real	F
Hillard	Ream	M
Arletta	Reams	F
Cherilyn	Reardon	F
Jullian	Reaves	M
Kavon	Reavis	M
Tzvi	Reber	M
Dejon	Rector	M
Lisha	Redd	F
Margarete	Redden	F
Shakia	Reddick	F
Caley	Redding	F
Glendora	Reddy	F
Aubriana	Redman	F
Shena	Redmon	F
Auther	Redmond	M
Delaine	Reece	F
Fairy	Reed	F
Kellye	Reeder	F
Kain	Reedy	M
Adriene	Reel	F
Taylar	Rees	F
Jaleah	Reese	F
Rustin	Reeve	M
Shanel	Reeves	F
Jaeda	Regalado	F
Melaine	Regan	F
Bodhi	Register	M
Wendall	Rego	M
Laticia	Reich	F
Jacelyn	Reichert	F
Anwar	Reid	M
Thresa	Reilly	F
Meir	Reimer	M
Josey	Reiner	F
Love	Reinert	F
Erlene	Reinhardt	F
Raelene	Reinhart	F
Coretta	Reinke	F
Josephina	Reis	F
Miyah	Reiser	F
Andrei	Reiss	M
Brynne	Reiter	F
Keion	Reitz	M
Dione	Remington	F
Hildegarde	Renaud	F
Kyndra	Rendon	F
Ashia	Renfro	F
Chadrick	Renfroe	M
Malak	Renner	F
Synthia	Reno	F
Berkley	Renteria	F
Jaye	Resendez	F
Candelaria	Resendiz	F
Frederica	Resnick	F
Jazzmine	Restrepo	F
Linton	Reuter	M
Koen	Revels	M
Malisa	Rex	F
Daveon	Rey	M
Geovanny	Reyes	M
Kenda	Reyna	F
Terron	Reynolds	M
Latrina	Reynoso	F
Rayven	Reza	F
Tavia	Rhea	F
Arica	Rhinehart	F
Georgeann	Rhoades	F
Nana	Rhoads	F
Maryalice	Rhoden	F
Rebbecca	Rhodes	F
Triniti	Rhone	F
Dimitrios	Rhyne	M
Daisey	Ribeiro	F
Kizzy	Ricci	F
Danisha	Riccio	F
Vania	Rice	F
Cameryn	Rich	F
Cherokee	Richard	F
Sarena	Richards	F
Fredia	Richardson	F
Gissel	Richey	F
Tavaris	Richie	M
Eriberto	Richman	M
Norton	Richmond	M
Rush	Richter	M
Emme	Rick	F
Amyah	Rickard	F
Coletta	Ricker	F
Jaysen	Rickert	M
Jeanmarie	Ricketts	F
Daja	Rickman	F
Fae	Ricks	F
Kelle	Rico	F
Brittnie	Riddell	F
Chevy	Riddick	M
Kimberely	Riddle	F
Geraldo	Ridenour	M
Rosaria	Rider	F
Masen	Ridge	M
Sumner	Ridgeway	M
Ashlin	Ridgway	F
Burley	Ridley	M
Carsyn	Riedel	F
Faron	Rieger	M
Sariyah	Ries	F
Marek	Rife	M
Siddharth	Riffle	M
Candance	Rigby	F
Devaughn	Rigdon	M
Katey	Riggins	F
Nicklas	Riggs	M
Joie	Rigney	F
Gennaro	Rigsby	M
Kelci	Riley	F
Roque	Rimsky-Korsakov	M
Kaileigh	Rinaldi	F
Laronda	Rincon	F
Tarra	Rinehart	F
Fabio	Ring	M
Lavelle	Ringer	M
Merilyn	Rinker	F
Shaquana	Riojas	F
Arin	Riordan	F
Denna	Rios	F
Sheilah	Ripley	F
Danniel	Risner	M
Loma	Ritchey	F
Roderic	Ritchie	M
Sanjuana	Rittenhouse	F
Xenia	Ritter	F
Celestina	Ritz	F
Deshon	Rivard	M
Tiffaney	Rivas	F
Verlie	Rivera	F
Cicely	Rivero	F
Lakendra	Rivers	F
Alexsandra	Rizo	F
Beverlee	Rizzo	F
Ozella	Roa	F
Taron	Roach	M
Chava	Roark	F
Amon	Robb	M
Jordi	Robbins	M
Laisha	Roberson	F
Madlyn	Robert	F
Tylan	Roberts	M
Beaulah	Robertson	F
Jannet	Robey	F
Latavia	Robin	F
Lucila	Robinette	F
Talya	Robins	F
Lashunda	Robinson	F
Melville	Robison	M
Taliah	Robledo	F
Alanis	Robles	F
Corbett	Robson	M
Gwenyth	Roby	F
Yesica	Rocco	F
Kamaria	Rocha	F
Abygail	Roche	F
Clover	Rock	F
Earlie	Rockwell	M
Arizona	Rodarte	F
Laquan	Rodas	M
Fulton	Roddy	M
Mikeal	Roden	M
Raechel	Roderick	F
Alianna	Rodgers	F
Gwenda	Rodman	F
Yazmine	Rodney	F
Delmas	Rodrigue	M
Jurnee	Rodrigues	F
Mcarthur	Rodriguez	M
Candelario	Rodriquez	M
Cassi	Roe	F
Sanjay	Roebuck	M
Cecilio	Roeder	M
Cosmo	Rogan	M
Emi	Roger	F
Hussein	Rogers	M
Imran	Rohde	M
Nino	Rohr	M
Daryn	Rohrer	M
Leonore	Rojas	F
Callan	Rojo	M
Jajuan	Roland	M
Tea	Roldan	F
Chesley	Rolfe	M
Glenwood	Roll	M
Kollin	Roller	M
Cardell	Rollins	M
Jamesha	Rolon	F
Silvestre	Roman	M
Antwain	Romano	M
Almeta	Rome	F
Mistie	Romeo	F
Mignon	Romero	F
Tari	Romine	F
Delfino	Romo	M
Rudolfo	Rone	M
Carrington	Roney	F
Kirstyn	Rood	F
Walt	Roof	M
Brissa	Rook	F
Chevelle	Rooks	F
Felipa	Rooney	F
Milburn	Roos	M
Thomasine	Root	F
Landin	Roper	M
Varun	Roque	M
Divya	Rosa	F
Izaak	Rosado	M
Mikaila	Rosales	F
Jenine	Rosario	F
Keoni	Rosas	M
Pamelia	Roscoe	F
Theodis	Rose	M
Lory	Rosen	F
Oneida	Rosenbaum	F
Manley	Rosenberg	M
Lashawnda	Rosenberger	F
Cianna	Rosenfeld	F
Teanna	Rosenthal	F
Tonisha	Ross	F
Abriana	Rosser	F
Jalon	Rossi	M
Twana	Rossman	F
Christiane	Roth	F
Avril	Rothman	F
Sanders	Rothwell	M
Reem	Rounds	F
Ronnell	Roundtree	M
Edyth	Rountree	F
Jaela	Rouse	F
Jourdan	Roush	F
Cathey	Rousseau	F
Marika	Rowan	F
Jenesis	Rowe	F
Kasi	Rowell	F
Vashti	Rowland	F
Elinore	Rowley	F
Delinda	Roy	F
Jens	Royal	M
Gabino	Roybal	M
Gregoria	Royce	F
Anastacio	Royer	M
Dominica	Royster	F
Neville	Rubalcava	M
Hedy	Rubenstein	F
Donya	Rubin	F
Jereme	Rubin-Vega	M
Arvel	Rubino	M
Coltin	Rubio	M
Demonte	Ruble	M
Eder	Ruby	M
Helga	Rucker	F
Dontay	Rudd	M
Wendie	Rude	F
Eliyahu	Rudolph	M
Jakari	Rudy	M
Tamyra	Rue	F
Chynna	Rueda	F
Ramses	Ruelas	M
Caylin	Ruff	F
Albertine	Ruffin	F
Ambar	Ruggiero	F
Virgle	Ruggles	M
Finis	Ruhl	M
Kylen	Ruiz	M
Anja	Rule	F
Authur	Rumsey	M
Dru	Runge	M
Ciro	Runnels	M
Damen	Runyan	M
Cady	Runyon	F
Derald	Rupert	M
Ramone	Rupp	M
Camellia	Ruppert	F
Saanvi	Rusch	F
Deandrea	Rush	F
Nadya	Rushing	F
Tamisha	Rusk	F
Karlyn	Russ	F
Katrice	Russel	F
Lillyana	Russell	F
Zavion	Russo	M
Thatcher	Rust	M
Siri	Ruth	F
Cian	Rutherford	M
Graeme	Rutkowski	M
Karey	Rutledge	F
Young	Rutter	M
Said	Ruvalcaba	M
Somer	Ryals	F
Arika	Ryan	F
Karren	Ryder	F
Jazzmin	Saad	F
Niesha	Saavedra	F
Daven	Sabin	M
Maison	Sabo	M
Maybell	Sacco	F
Ozzie	Sachs	M
Author	Sackett	M
Tennille	Sacks	F
Chasidy	Sadler	F
Mardell	Sadowski	F
Blain	Saechao	M
Stasia	Saenz	F
Deedra	Sage	F
Lew	Sager	M
Khari	Sain	M
Lynelle	Saint-Saens	F
Willem	Saito	M
Ceola	Saiz	F
Jeron	Salas	M
Serene	Salazar	F
Artemio	Salcedo	M
Mendy	Salcido	F
Rania	Saldana	F
Lauralee	Saldivar	F
Nala	Saleh	F
Pascal	Salem	M
Nat	Salerno	M
Rashid	Sales	M
Milly	Salgado	F
Raylan	Salinas	M
Dannette	Salisbury	F
Emelie	Sallee	F
Emmer	Salley	F
Charise	Salmeron	F
Stefania	Salmon	F
Dayle	Salomon	F
Kelis	Salter	F
Dov	Saltzman	M
Kierstyn	Salvador	F
Inell	Salvatore	F
Fidencio	Salyer	M
Theressa	Salyers	F
Travion	Sam	M
Baldemar	Samaniego	M
Deegan	Sammons	M
Jayvion	Sample	M
Margaux	Samples	F
Chassity	Sampson	F
Zach	Sams	M
Gracey	Samson	F
Juliane	Samuel	F
Kaidence	Samuels	F
Tahlia	Samuelson	F
Raye	Sanabria	F
Towanda	Sanborn	F
Jann	Sanches	F
Tamica	Sanchez	F
Nariah	Sand	F
Feliciano	Sandberg	M
Shelba	Sander	F
Ariadna	Sanders	F
Jaila	Sanderson	F
Briseida	Sandhu	F
Daijah	Sandifer	F
Jeanelle	Sandler	F
Maryrose	Sandlin	F
Tequila	Sandoval	F
Italia	Sands	F
Sueann	Sandy	F
Jairus	Sanfilippo	M
Thompson	Sanford	M
Devora	Sanmiguel	F
Talmage	Sansone	M
Willette	Santacruz	F
Khalia	Santamaria	F
Quinlan	Santana	M
Allisson	Santangelo	F
Marquetta	Santiago	F
Raekwon	Santillan	M
Zoya	Santoro	F
Amariah	Santos	F
Luci	Santoyo	F
Elio	Sapp	M
Musa	Sarabia	M
Thane	Sargent	M
Catelyn	Sarmiento	F
Foy	Sarver	M
Henery	Sass	M
Imari	Sasser	F
Janya	Sato	F
Aryeh	Satterfield	M
Celso	Satterwhite	M
Elza	Sattler	M
Jaymes	Sauceda	M
Lanell	Saucedo	F
Marilu	Saucier	F
Amal	Sauer	F
Arik	Saul	M
Shan	Sauls	M
Courtnie	Saunders	F
Keena	Sauter	F
Lachlan	Savage	M
Youssef	Savino	M
Armaan	Savoie	M
Hagen	Savoy	M
Petrina	Sawyer	F
Alston	Sawyers	M
Karyl	Saxon	F
Keshaun	Saxton	M
Amada	Sayers	F
Corry	Sayles	M
Faigy	Saylor	F
Javian	Sayre	M
Kamiyah	Scales	F
Lilyann	Scanlan	F
Tavis	Scanlon	M
Idris	Scarborough	M
Zadie	Scarbrough	F
Ariyah	Schaaf	F
Donavin	Schaefer	M
Euna	Schaeffer	F
Theola	Schafer	F
Guinevere	Schaffer	F
Lake	Schaller	M
Maris	Scharf	F
Cristie	Schatz	F
Shemar	Schaub	M
Taurean	Schauer	M
Brinda	Scheer	F
Lindsy	Schell	F
Lucca	Schenck	M
Massimo	Schenk	M
Peri	Scherer	F
Rosalva	Schick	F
Conrado	Schiller	M
Gitty	Schilling	F
Heide	Schindler	F
Wendel	Schlegel	M
Cipriano	Schlosser	M
Ileen	Schlueter	F
Porsche	Schmid	F
Flo	Schmidt	F
Osman	Schmit	M
Tiny	Schmitt	F
Felica	Schmitz	F
Kaniya	Schneider	F
Rowen	Schnell	M
Bianka	Schoen	F
Kirra	Schofield	F
Verdell	Scholl	F
Corrinne	Scholz	F
Greer	Schoonover	F
Harmoni	Schott	F
Jarad	Schrader	M
Breon	Schram	M
Celesta	Schramm	F
Jeshua	Schreiber	M
Kipp	Schreiner	M
Sebrina	Schrock	F
Delena	Schroder	F
Omega	Schroeder	F
Jamilah	Schubert	F
Gisel	Schuh	F
Izaac	Schuler	M
Mariya	Schulman	F
Yash	Schulte	M
Thora	Schultz	F
Reena	Schulz	F
Audrea	Schulze	F
Brecken	Schumacher	M
Desi	Schuman	M
Marivel	Schumann	F
Krissy	Schuster	F
Cleopatra	Schutt	F
Floretta	Schutte	F
Ailene	Schutz	F
Crew	Schwab	M
Malea	Schwartz	F
Tatiyana	Schwarz	F
Meera	Schweitzer	F
Lillia	Scofield	F
Isamar	Scoggins	F
Joline	Scott	F
Samaya	Scribner	F
Vernard	Scroggins	M
Arissa	Scruggs	F
Citlalli	Scully	F
Cordie	Seal	F
Derrik	Seale	M
Patrina	Seals	F
Seanna	Seaman	F
Worth	Searcy	M
Hendrix	Searle	M
Kateri	Searles	F
Myia	Sears	F
Shala	Seaton	F
Suri	Seay	F
Vic	Sebastian	M
Amayah	See	F
Marah	Seeley	F
Taelor	Seely	F
Takisha	Segal	F
Daylan	Seger	M
Garner	Segovia	M
Mellie	Segura	F
Nautica	Seibel	F
Kirkland	Seibert	M
Makyla	Seidel	F
Vanita	Seifert	F
Glennis	Seiler	F
Ariyanna	Seitz	F
Kelcey	Selby	F
Augustina	Self	F
Mick	Sell	M
Orland	Sellars	M
Ewell	Sellers	M
Exie	Sells	F
Khristopher	Seltzer	M
Javin	Sena	M
Karime	Senn	F
Latina	Sepulveda	F
Samone	Serafin	F
Daniell	Serna	F
Detra	Serra	F
Luetta	Serrano	F
Passion	Serrato	F
Arnita	Servin	F
Coen	Sessions	M
Landis	Settle	M
Romel	Settles	M
Lillyanna	Setzer	F
Trula	Severson	F
Ashlei	Sevilla	F
Macayla	Seward	F
Michela	Sewell	F
Apollo	Sexton	M
Arlyn	Seymore	M
Cheree	Seymour	F
Kyah	Shackelford	F
Kyran	Shade	M
Lanora	Shafer	F
Mahmoud	Shaffer	M
Mendel	Shah	M
Gorden	Shanahan	M
Marya	Shane	F
Mikki	Shaner	F
Taneisha	Shank	F
Vella	Shanks	F
Ariadne	Shannon	F
Cataleya	Shapiro	F
Giulia	Sharkey	F
Zana	Sharma	F
Conway	Sharp	M
Green	Sharpe	M
Marylynn	Shattuck	F
Richardo	Shaughnessy	M
Aleen	Shaver	F
Kedrick	Shaw	M
Layna	Shay	F
Myka	Shea	F
Tyran	Shealy	M
Ubaldo	Shearer	M
Eudora	Sheehan	F
Eilene	Sheehy	F
Ciana	Sheets	F
Lelah	Sheffield	F
Perri	Shelby	F
Shanya	Sheldon	F
Kaeli	Shell	F
Shamya	Shelley	F
Jetta	Shelly	F
Kamora	Shelton	F
Delpha	Shen	F
Ilse	Shepard	F
Marino	Shephard	M
Maycee	Shepherd	F
Niyah	Sheppard	F
Allissa	Sherer	F
Cleophus	Sheridan	M
Gaylen	Sherlock	M
Mccoy	Sherman	M
Gianluca	Sherrill	M
Maylee	Sherrod	F
Charlsie	Sherry	F
Cinnamon	Sherwood	F
Kaydee	Shi	F
Shaye	Shields	F
Temperance	Shifflett	F
Hilbert	Shih-Kai	M
Nicol	Shilling	F
Benjaman	Shin	M
Ellianna	Shine	F
Michelina	Shinn	F
Rain	Shipley	F
Skip	Shipman	M
Tamira	Shipp	F
Acie	Shirey	M
Boone	Shirk	M
Corissa	Shirley	F
Kaycie	Shively	F
Theresia	Shiver	F
Abbigale	Shivers	F
Tyreek	Shockey	M
Arionna	Shockley	F
Glynis	Shoemaker	F
Janise	Shook	F
Marius	Shope	M
Andrey	Shore	M
Michaella	Shores	F
Nazir	Short	M
Chancellor	Shorter	M
Kassi	Shoup	F
Maxton	Shouse	M
Coralee	Showalter	F
Mikah	Showers	M
Talisa	Shrader	F
Elenor	Shreve	F
Mathieu	Shriver	M
Veta	Shropshire	F
Narciso	Shrum	M
Noella	Shuler	F
Tyrek	Shull	M
Ariela	Shultz	F
Herb	Shumaker	M
Kendric	Shuman	M
Arnie	Shumate	M
Damond	Shumway	M
Kennth	Shupe	M
Rosalynn	Shuster	F
Brentley	Sibley	M
Johnette	Siddiqui	F
Demetric	Sides	M
Gwyn	Siebert	F
Kacee	Siegel	F
Emmalynn	Sierra	F
Joette	Sievers	F
Katheryne	Sifuentes	F
Anai	Sigler	F
Consuela	Sigmon	F
Coralie	Sikes	F
Frazier	Sikora	M
Arsenio	Sikorski	M
Darel	Siler	M
Lauro	Sills	M
Alphonzo	Silva	M
Indira	Silveira	F
Belia	Silver	F
Lillyan	Silverman	F
Rebekka	Silvers	F
Candido	Silverstein	M
Christain	Silvestri	M
Erskine	Silvia	M
Donetta	Sim	F
Nikola	Simmons	M
Servando	Simms	M
Neda	Simon	F
Felisa	Simonds	F
Larkin	Simone	M
Colson	Simons	M
Heyward	Simonson	M
Tova	Simpkins	F
Khristian	Simpson	M
Daleyza	Sims	F
Jenee	Sinclair	F
Jaedon	Singer	M
Sunday	Singh	F
Sven	Singletary	M
Egypt	Singleton	F
Kalel	Sink	M
Kenzi	Sipe	F
Pierson	Sipes	M
Taleah	Sisco	F
Zoraida	Sisk	F
Lavar	Sisneros	M
Shaquan	Sisson	M
Cassy	Sites	F
Gabriele	Sizemore	F
Jacklynn	Skaggs	F
Markeith	Skeen	M
Yanet	Skelton	F
Hermelinda	Skidmore	F
Kalena	Skiles	F
Alonna	Skinner	F
Honor	Skipper	F
Zetta	Slack	F
Atlas	Slade	M
Bradon	Slagle	M
Bode	Slate	M
Tyasia	Slater	F
January	Slaton	F
Latarsha	Slattery	F
Sharie	Slaughter	F
Callista	Slayton	F
Sanjana	Sledge	F
Birtha	Sloan	F
Joziah	Slocum	M
Preslee	Slone	F
Akash	Slusher	M
Avani	Small	F
Cayson	Smalley	M
Olyvia	Smalls	F
Johnmichael	Smallwood	M
Serafina	Smart	F
Brayton	Smedley	M
Breona	Smiley	F
Elli	Smit-McPhee	F
Shaylynn	Smith	F
Cormac	Smithson	M
Jule	Smock	F
Pietro	Smoot	M
Sherika	Smothers	F
Sabrena	Smyth	F
Cienna	Smythe	F
Faris	Snapp	M
Hakim	Snead	M
Georgiann	Sneed	F
Leisha	Snell	F
Lynell	Snider	F
Ellwood	Snipes	M
Kalista	Snodgrass	F
Kannon	Snook	M
Verner	Snow	M
Andrae	Snowden	M
Arnaldo	Snyder	M
Erie	So	M
Rosalio	Soares	M
Shaniece	Sokol	F
Syreeta	Solano	F
Tyre	Solberg	M
Pearlene	Soler	F
Pooja	Solis	F
Takia	Soliz	F
Kaily	Solomon	F
Beck	Solorio	M
Fredericka	Solorzano	F
Gema	Somers	F
Jamell	Somerville	M
Jossie	Sommer	F
Tanaya	Sommers	F
Contessa	Son	F
Lovina	Song	F
Mattison	Sonnier	F
Boden	Soper	M
Shalyn	Sorensen	F
Antwone	Sorenson	M
Donielle	Soria	F
Shaylyn	Soriano	F
Kyana	Sorrell	F
Landan	Sorrells	M
Ruthe	Sorrentino	F
Levar	Sosa	M
Adnan	Sotelo	M
Dionicio	Soto	M
Felicitas	Soucy	F
Sammantha	Soule	F
Zyon	Sousa	M
Calen	South	M
Jarren	Southard	M
Jaymee	Southerland	F
Riana	Southern	F
Babyboy	Southworth	M
Murl	Souza	M
Miquel	Sowell	M
Shiann	Sowers	F
Waverly	Spain	M
Jashawn	Spalding	M
Briggs	Spangler	M
Penney	Spann	F
Aanya	Spano	F
Faviola	Sparkman	F
Johathan	Sparks	M
Joscelyn	Sparrow	F
Orvil	Spaulding	M
Roselle	Spear	F
Scout	Spearman	F
Viktor	Spears	M
Yakov	Specht	M
Corrin	Speck	F
Jina	Spector	F
Kevyn	Speed	M
Laurance	Speer	M
Sim	Speight	M
Thais	Spell	F
Abbi	Spellman	F
Che	Spence	M
Coley	Spencer	M
Glennie	Sperling	F
Sulema	Sperry	F
Deeanna	Spicer	F
Epifanio	Spiegel	M
Kyrsten	Spikes	F
Lavonna	Spiller	F
Jenette	Spillman	F
Leeland	Spina	M
Renay	Spinelli	F
Dorathy	Spinks	F
Maddux	Spires	M
Andree	Spitzer	F
Carlota	Spivey	F
Bartley	Spooner	M
Beyonce	Spradlin	F
Camdyn	Sprague	M
Melissia	Spratt	F
Abran	Spriggs	M
Cyle	Spring	M
Dajah	Springer	F
Darcey	Sprinkle	F
Markayla	Sprouse	F
Dynasty	Spruill	F
Woodie	Spurgeon	M
Vihaan	Spurlock	M
Jermain	Squire	M
Kyli	Squires	F
Zahir	Staats	M
Baila	Stacey	F
Alline	Stack	F
Anyssa	Stackhouse	F
Melyssa	Stacy	F
Diandra	Stadler	F
Diedra	Stafford	F
Janea	Staggs	F
Malaika	Stahl	F
Olevia	Stahl-David	F
Darris	Staley	M
Jaquez	Stallings	M
Margarite	Stallworth	F
Vianney	Stambaugh	F
Brysen	Stamm	M
Dafne	Stamper	F
Kiran	Stamps	M
Aysia	Stancil	F
Maryelizabeth	Standley	F
Alen	Standridge	M
Ambria	Stanek	F
Shannen	Stanfield	F
Mortimer	Stanford	M
Mychal	Stanley	M
September	Stansbury	F
Tatyanna	Stanton	F
Kaylani	Staples	F
Jesiah	Stapleton	M
Yonatan	Stark	M
Osiel	Starkey	M
Ferrell	Starks	M
Jamiah	Starling	F
Jianna	Starnes	F
Kary	Starr	F
Caelyn	Staten	F
Jolyn	Staton	F
Katharina	Staub	F
Emir	Stauffer	M
Juelz	Stclair	M
Lavonia	Steadman	F
Pyper	Stearns	F
Levern	Stebbins	M
Dorman	Stedman	M
Jenica	Steed	F
Jacorey	Steel	M
Lakiesha	Steele	F
Maylin	Steelman	F
Charleston	Steen	M
Tex	Steenis-Gondi	M
Chesney	Steffen	F
Noma	Steffens	F
Kamiya	Stegall	F
Ole	Steger	M
Jamaya	Stein	F
Stormi	Steinberg	F
Jarrad	Steiner	M
Jesusa	Steinke	F
Klayton	Steinmetz	M
Natividad	Stenger	F
Theophilus	Stephan	M
Ellena	Stephen	F
Guillermina	Stephen-Daly	F
Ilan	Stephens	M
Jala	Stephenson	F
Marykate	Stepp	F
Casimer	Sterling	M
Jenice	Stern	F
Nadene	Sterner	F
Letisha	Stevens	F
Sahar	Stevenson	F
Deloise	Steward	F
Kohen	Stewart	M
Danni	Stickney	F
Elam	Stidham	M
Lurline	Stiles	F
Nerissa	Still	F
Damani	Stillman	M
Doloris	Stillwell	F
Keosha	Stilwell	F
Peighton	Stine	F
Therman	Stinnett	M
Titan	Stinson	M
Beatrix	Stith	F
Mickel	Stitt	M
Tamekia	Stivers	F
Tamesha	Stjohn	F
Kimball	Stlouis	M
Tehya	Stock	F
Shawana	Stockdale	F
Sherrod	Stocker	M
Ravyn	Stockman	F
Willetta	Stocks	F
Ewan	Stockton	M
Lyndell	Stockwell	M
Taraji	Stoddard	F
Blessing	Stoker	F
Rio	Stokes	M
Britny	Stoll	F
Felicita	Stoltz	F
Karyme	Stoltzfus	F
Aries	Stone	M
Tawni	Stoner	F
Hipolito	Storey	M
Saray	Storm	F
Sutton	Storms	M
Berton	Story	M
Hanah	Stott	F
Irena	Stotts	F
Lajuana	Stout	F
Shanequa	Stovall	F
Newman	Stover	M
Nubia	Stowe	F
Verlene	Stowell	F
Raj	Stowers	M
Rayfield	Stpierre	M
Zephaniah	Strader	M
Dovid	Straight	M
Eulah	Strain	F
Gust	Strait	M
Marshawn	Strand	M
Meda	Strang	F
Breck	Strange	M
Neely	Stratton	F
Zebulon	Straub	M
Elodie	Strauss	F
Angelene	Strawn	F
Tarek	Street	M
Rome	Streeter	M
Valda	Stricker	F
Caelan	Strickland	M
Korie	Strickler	F
Marylouise	Stricklin	F
Winton	Stringer	M
Micaiah	Stringfellow	M
Rayanna	Strobel	F
Cherlyn	Stroh	F
Rondal	Strom	M
Neftali	Strong	M
Sacha	Strother	F
Dev	Stroud	M
Maye	Stroup	F
Natisha	Struble	F
Rhyan	Strunk	F
Viktoria	Stuart	F
Cosette	Stubblefield	F
Janyce	Stubbs	F
Jesslyn	Stuckey	F
Merrilee	Studer	F
Monae	Stull	F
Rosamaria	Stultz	F
Wayde	Stump	M
Goldia	Stumpf	F
Hilliard	Sturdivant	M
Lanna	Sturgeon	F
Lannie	Sturgill	M
Jori	Sturgis	F
Monnie	Sturm	F
Oskar	Stutzman	M
Silvana	Styles	F
Tino	Su	M
Tilda	Suarez	F
Desirea	Suggs	F
Wynn	Suh	M
Emmaleigh	Sullivan	F
Karsen	Summerlin	M
Mckay	Summers	M
Tala	Summerville	F
Taurus	Sumner	M
Corbyn	Sumpter	M
Angelle	Sun	F
Kaine	Sunderland	M
Myriah	Sung	F
Enriqueta	Surratt	F
Florinda	Sussman	F
Adriano	Suter	M
Deyanira	Sutherland	F
Emoni	Sutphin	F
Hershell	Sutter	M
Maryn	Suttles	F
San	Sutton	F
Takiyah	Suzuki	F
Tristyn	Svoboda	F
Bentlee	Swafford	M
Aleesha	Swaim	F
Aman	Swain	M
Brighton	Swan	M
Dain	Swank	M
Mackenzi	Swann	F
Reda	Swanson	F
Veola	Swart	F
Jazelle	Swartz	F
Mariaelena	Swearingen	F
Yadiel	Sweat	M
Mayah	Sweeney	F
Shekinah	Sweet	F
Aide	Swenson	F
Marcial	Swick	M
Jerrick	Swift	M
Shenika	Swindell	F
Nicholle	Swindle	F
Violetta	Swinney	F
Carsten	Swisher	M
Ethelene	Switzer	F
Josalyn	Swope	F
Jovana	Syed	F
Tesla	Sykes	F
Kooper	Sylvester	M
Marry	Sylvia	F
Kerrigan	Szabo	F
Makiah	Szymanski	F
Mecca	Ta	F
Araya	Tabb	F
Myrl	Taber	F
Malek	Tabor	M
Mertie	Tackett	F
Ruel	Tafoya	M
Laird	Taft	M
Naim	Taggart	M
Ryon	Tait	M
Tyisha	Takahashi	F
Alease	Talavera	F
Fenton	Talbert	M
Mahalia	Talbot	F
Zipporah	Talbott	F
Francie	Tallent	F
Kiefer	Talley	M
Seana	Tallman	F
Deryl	Tam	M
Carys	Tamayo	F
Taja	Tamez	F
Baileigh	Tan	F
Mozella	Tanaka	F
Ressie	Tang	F
Kailah	Tankersley	F
Cliffton	Tanner	M
Allena	Tapia	F
Cortland	Tapp	M
Darl	Tarango	M
Neida	Tarr	F
Sunni	Tarver	F
Tambra	Tate	F
Viki	Tatro	F
Zhane	Tatum	F
Michaele	Tavares	F
Vergil	Tavarez	M
Bunny	Taveras	F
Candra	Taylor	F
Eston	Taylor-Gordon	M
Asya	Taylor-Taylor	F
Poppy	Teague	F
Donella	Teal	F
Shawnta	Tedder	F
Ayva	Tedesco	F
Braedyn	Teel	M
Brando	Teeter	M
Dmitri	Teixeira	M
Neill	Tejada	M
Parris	Tejeda	M
Aerial	Telles	F
Annice	Tellez	F
Antonino	Tello	M
Pepper	Temple	F
Lady	Templeton	F
Maryah	Tennant	F
Melita	Tenney	F
Akil	Tenorio	M
Milani	Teran	F
Arlis	Terrazas	M
Kellyann	Terrell	F
Dyan	Terrill	F
Elder	Terry	M
Hildegard	Testa	F
Latrisha	Tew	F
Molli	Thach	F
Tesha	Thacker	F
Rafe	Thai	M
Etha	Thames	F
Falon	Thao	F
Long	Tharp	M
Rohit	Tharpe	M
Nika	Thatcher	F
Rakeem	Thaxton	M
Wolfgang	Thayer	M
Alyna	Theis	F
Clora	Theisen	F
Yulisa	Thelen	F
Charlena	Theobald	F
Eliel	Theriault	M
Jihad	Theriot	M
Latashia	Therrien	F
Tyreese	Thibault	M
Ramond	Thibodeau	M
Armen	Thibodeaux	M
Durrell	Thiel	M
Lydell	Thiele	M
Gracia	Thies	F
Anayeli	Thigpen	F
Benjamine	Thom	M
Diedre	Thomas	F
Valeri	Thomason	F
Delwin	Thomasson	M
Hortensia	Thompkins	F
Jennica	Thompson	F
Blade	Thomsen	M
Gertha	Thomson	F
Lavona	Thorn	F
Loretha	Thornburg	F
Shirleen	Thorne	F
Elodia	Thornhill	F
Georgeanna	Thornton	F
Evaristo	Thorp	M
Tyren	Thorpe	M
Helaine	Thorson	F
Nicoletta	Thrash	F
Flint	Thrasher	M
Vernal	Thrower	M
Antoni	Thurman	M
Charlyn	Thurmond	F
Onie	Thurston	F
Alvah	Tibbetts	M
Lisamarie	Tibbs	F
Tj	Tice	M
Aubrielle	Tidwell	F
Demitrius	Tierney	M
Laurent	Tiffany	M
Miriah	Tighe	F
Ammar	Tijerina	M
Emelyn	Tiller	F
Gaspar	Tillery	M
Keaira	Tilley	F
Braylin	Tillman	M
Dymond	Tilton	F
Fantasia	Timberlake	F
Raine	Timm	F
Tavian	Timmerman	M
Bari	Timmons	F
Ettie	Timms	F
Lashawna	Tindall	F
Nour	Tingle	F
Sharilyn	Tinker	F
Janita	Tinoco	F
Kaleena	Tinsley	F
Francheska	Tipton	F
Saad	Tirado	M
Kezia	Tisdale	F
Wonda	Tittle	F
Vianca	Titus	F
Coraline	To	F
Crysta	Tobar	F
Dezirae	Tobias	F
Brianda	Tobin	F
Anakin	Todd	M
Dedric	Toland	M
Lemar	Tolbert	M
Keilani	Toledo	F
Morgen	Tolentino	F
Cloey	Toler	F
Dyana	Toliver	F
Madelon	Tolley	F
Tyce	Tolliver	M
Rayvon	Tolson	M
Janella	Tom	F
Louanne	Tomas	F
Bayley	Tomlin	F
Kayleb	Tomlinson	M
Ishan	Tompkins	M
Minh	Toms	M
Klara	Toner	F
Tashina	Toney	F
Verle	Tong	M
Cherryl	Toole	F
Shaniah	Toombs	F
Nickolaus	Toomey	M
Nunzio	Torgerson	M
Nilsa	Toro	F
Demetrice	Torre	F
Lenord	Torrence	M
Jad	Torres	M
Kanesha	Torrey	F
Kellyn	Torrez	F
Dia	Toscano	F
Elberta	Toth	F
Lorina	Totten	F
Andreana	Toussaint	F
Hayli	Tovar	F
Jerrad	Tower	M
Lorita	Towers	F
Marlow	Towne	M
Nohemi	Townes	F
Steffany	Towns	F
Margurite	Townsend	F
Sabino	Toy	M
Ariya	Tracey	F
Bently	Tracy	M
Desarae	Trahan	F
Macon	Trainor	M
Shalanda	Trammell	F
Mckenzi	Tran	F
Angely	Trapp	F
Brooklin	Trask	F
Creola	Travers	F
Kamran	Travis	M
Marli	Traylor	F
Kizzie	Treadway	F
Rheanna	Treadwell	F
Rossie	Treat	F
Laurice	Trejo	F
Maximino	Tremblay	M
Shandi	Trent	F
Anel	Trevino	F
Vann	Trevor-Roper	M
Caridad	Tribble	F
Ragan	Trice	F
Rashon	Trimble	M
Calandra	Trinh	F
Yahya	Trinidad	M
Calleigh	Triplett	F
Carver	Tripp	M
Dusti	Trombley	F
Isacc	Trott	M
Mickayla	Trotter	F
Oliva	Trout	F
Keonna	Troutman	F
Jahir	Trowbridge	M
Isom	Troxell	M
Johannes	Troy	M
Arwen	Troyer	F
Parth	Truax	M
Wava	Trudeau	F
Xitlali	TRUE	F
Amaria	Truesdale	F
Saverio	Truitt	M
Trevis	Trujillo	M
Arland	Truman	M
Awilda	Truong	F
Estephanie	Tryon	F
Francene	Tsai	F
Marybelle	Tsang	F
Arcelia	Tse	F
Babygirl	Tseng	F
Demarius	Tsosie	M
Georgann	Tu	F
Merideth	Tubbs	F
Bea	Tuck	F
Keysha	Tucker	F
Minor	Tudor	M
Rori	Tuggle	F
Aramis	Tull	M
Sandee	Tully	F
Ameera	Turcotte	F
Aris	Turk	M
Conan	Turley	M
Muhammed	Turman	M
Eligah	Turnage	M
Girard	Turnbull	M
Tramaine	Turner	M
Harlon	Turney	M
Luanna	Turpin	F
Nahla	Tuttle	F
Krishna	Tyler	M
Alfonza	Tyndall	M
Junious	Tyner	M
Marinda	Tyree	F
Amerie	Tyrrell	F
Burdette	Tyson	M
Dorie	Uhl	F
Jacen	Ulloa	M
Loralee	Ulmer	F
Analicia	Ulrich	F
Catheryn	Underhill	F
Cleora	Underwood	F
Kena	Unger	F
Jet	Unruh	M
Amberlee	Upchurch	F
Lakyn	Upshaw	F
Laure	Upton	F
Barrie	Urban	F
Maisha	Urbina	F
Demitri	Urena	M
Jiselle	Urias	F
Arrie	Uribe	F
Billi	Urrutia	F
Chelsee	Usher	F
Cinthya	Ussery	F
Kc	Utley	M
Jacquetta	Utter	F
Kameryn	Vaca	F
Ozell	Vaccaro	M
Rylen	Vail	M
Taylin	Valadez	F
Tyshaun	Valdes	M
Kaylei	Valdez	F
Tyrique	Valdivia	M
Dalen	Valdovinos	M
Kyrah	Valencia	F
Lael	Valente	F
Raeanne	Valenti	F
Taran	Valentin	M
Umar	Valentine	M
Dashiell	Valentino	M
Desiray	Valenzuela	F
Emili	Valerio	F
Lasonya	Valladares	F
Migel	Valle	M
Kyanna	Vallejo	F
Chayse	Valles	M
Rosy	Valley	F
Xavion	Valverde	M
Katilyn	Van	F
Verlon	VanBuren	M
Cort	VanDerWeyer	M
Dustan	VanDyke	M
Mayer	VanHoak	M
Zoila	VanHouten	F
Loris	VanHouwe	F
Alita	VanKleck	F
Miki	VanMeter	F
Shaunte	VanOlinda	F
Amity	VanPelt	F
Cher	VanSickle	F
Jadah	VanWinkle	F
Julene	VanWysenberghe	F
Justyce	Vanbuskirk	F
Yovani	Vance	M
Concha	Vandenberg	F
Devonna	VanderNeut	F
Leilany	VanderTol	F
Basilio	VanderWegen	M
Durell	VanderWilligen	M
Elizabet	Vanderpool	F
Markanthony	Vandiver	M
Jailynn	Vanegas	F
Shanique	Vang	F
Shaylin	Vanhorn	F
Angelie	Vann	F
Charly	Vanover	F
Dontavious	Varela	M
Margene	Varga	F
Genelle	Vargas	F
Rasheeda	Varghese	F
Jennyfer	Vargo	F
Julious	Varner	M
Lizzette	Varney	F
Melania	Vasquez	F
Aharon	Vaughan	M
Gisell	Vaughn	F
Ashwin	Vaught	M
Britnee	Vazquez	F
Emerie	Veach	F
Fayth	Veal	F
Caeden	Vega	M
Romie	Vela	M
Stephine	Velarde	F
Vanda	Velasco	F
Karisma	Velasquez	F
Abdulrahman	Velazquez	M
Annah	Velez	F
Malique	Veliz	M
Tempie	VenDerWeyer	F
Garren	Venable	M
Kaira	Venegas	F
Randon	Ventura	M
Almira	Vera	F
Montie	Verdin	M
Breeana	Verdugo	F
Lavenia	Verduzco	F
Zahara	Vergara	F
Korbyn	Vermillion	M
Lonie	Vernon	F
Madolyn	Vest	F
Shanti	Vestal	F
Silverio	Vetter	M
Cayleigh	Via	F
Karlos	Vice	M
Noam	Vicente	M
Vishal	Vick	M
Eliazar	Vickers	M
Arlean	Vickery	F
Yana	Victor	F
Kimi	Victoria	F
Mitzie	Vidal	F
Romana	Vieira	F
Treasa	Viera	F
Cherelle	Vigil	F
Dietrich	Villa	M
Londa	Villa-Lobos	F
Malvina	Villagomez	F
Adamari	Villalobos	F
Shakayla	Villalpando	F
Tynisha	Villanueva	F
Bernabe	Villareal	M
Flavia	Villarreal	F
Florance	Villasenor	F
Sharmaine	Villatoro	F
Daryll	Villegas	M
Lakenya	Vincent	F
Lamya	Vines	F
Naida	Vining	F
Lala	Vinson	F
Pearly	Viola	F
Anayah	Viramontes	F
Ebonee	Visser	F
Lamonica	Vitale	F
Canon	Vo	M
Genia	Voelker	F
Julieanne	Vogel	F
Kilee	Vogt	F
Nayla	Voigt	F
Cally	Volk	F
Maple	Vollmer	F
Verena	Volpe	F
Vivek	Volz	M
Amee	Voorhees	F
Clarine	Voss	F
Najah	Voyles	F
Dotty	Vu	F
Milania	Vue	F
Amiee	Vuong	F
Cordero	Wachter	M
Kalin	Waddell	M
Cassey	Wade	F
Genevie	Wadsworth	F
Hughie	Waggoner	M
Nickey	Wagner	M
Orie	Wagoner	M
Eladio	Wahl	M
Janelly	Wainwright	F
Kainoa	Waite	M
Oris	Waits	M
Shamus	Wakefield	M
Suzannah	Wald	F
Alane	Walden	F
Albino	Waldman	M
Carline	Waldo	F
Ellamae	Waldron	F
Jalin	Waldrop	M
Osmar	Wales	M
Emiley	Walker	F
Konstantinos	Wall	M
Illa	Wallace	F
Marygrace	Wallen	F
Alexavier	Waller	M
Leron	Walley	M
Dessa	Wallin	F
Elisheva	Walling	F
Harmonie	Wallis	F
Henley	Walls	F
Ieshia	Walsh	F
Jansen	Walston	M
Oneil	Walter	M
Briona	Walters	F
Kelsee	Walther	F
Khaled	Waltman	M
Neomi	Walton	F
Achilles	Waltz	M
Criselda	Walz	F
Bernhard	Wampler	M
Hadlee	Wan	F
Asma	Wang	F
Graysen	Ward	M
Isael	Warden	M
Larita	Ware	F
Phaedra	Warfield	F
Quincey	Wargo	M
Aime	Waring	F
Devion	Warner	M
Drayton	Warnock	M
Finnian	Warren	M
Rea	Warrick	F
Destanie	Warrington	F
Lakin	Warwick	F
Sanya	Wash	F
Truett	Washburn	M
Arletha	Washington	F
Erline	Wasserman	F
Keya	Wasserman-Schultz	F
Steele	Wasson	M
Jadelyn	Watanabe	F
Brodrick	Waterman	M
Laddie	Waters	M
Samanta	Watford	F
Adena	Watkins	F
Jarius	Watson	M
Albertina	Watt	F
Marchelle	Watters	F
Maryssa	Watts	F
Nakayla	Waugh	F
Calvert	Way	M
Crispin	Wayman	M
Francois	Wayne	M
Filip	Weatherford	M
Naila	Weatherly	F
Stacee	Weathers	F
Whittney	Weatherspoon	F
Benard	Weaver	M
Krisha	Webb	F
Krystyna	Webber	F
Leyton	Weber	M
Rhona	Webster	F
Anaiah	Weddle	F
Haileigh	Weed	F
Zakaria	Weeks	M
Aj	Weems	M
Justo	Weese	M
Shaan	Wegner	M
Sixto	Wei	M
Yocheved	Weidman	F
Corin	Weidner	F
Kolin	Weigel	M
Marquan	Weil	M
Lakita	Weiland	F
Lorenz	Weiler	M
Dea	Weimer	F
Adelita	Weinberg	F
Akiva	Weinberger	M
Harlin	Weiner	M
Jameka	Weinstein	F
Kylene	Weir	F
Merwin	Weis	M
Benicio	Weiser	M
Colene	Weisman	F
Jeanpaul	Weiss	M
Andriana	Weissman	F
Harvie	Weitzel	M
Izetta	Welborn	F
Kalei	Welch	F
Rani	Weldon	F
Shaunda	Welker	F
Naomie	Weller	F
Sherril	Wellington	F
Shilo	Wellman	F
Tyrin	Wells	M
Catarino	Welsh	M
Gatlin	Welter	M
Lynna	Welton	F
Mylah	Welty	F
Brittnay	Wendel	F
Francina	Wendt	F
Rochell	Wenger	F
Yolande	Wentworth	F
Jona	Wentz	F
Quran	Wenzel	M
Clarabelle	Werner	F
Eris	Wert	F
Nakiya	Wertz	F
Demetrious	Wescott	M
Kase	Wesley	M
Bracha	Wessel	F
Cord	Wesson	M
Symphony	West	F
Katharyn	Westbrook	F
Kimiko	Westcott	F
Valente	Wester	M
Zayd	Westerman	M
Elisia	Westfall	F
Eman	Westmoreland	F
Dagoberto	Weston	M
Jashua	Westover	M
Kenith	Westphal	M
Skylee	Wetzel	F
Yaretzy	Whalen	F
Chasen	Whaley	M
Darlyn	Wharton	F
Kennon	Whatley	M
Marijane	Wheat	F
Serafin	Wheatley	M
Anand	Wheaton	M
Almon	Wheeler	M
Dede	Whelan	F
Eian	Whetstone	M
Esai	Whipple	M
Orson	Whitacre	M
Paulino	Whitaker	M
Classie	Whitcomb	F
Jomar	White	M
Lisandro	Whited	M
Aleyah	Whitehead	F
Lainie	Whitehouse	F
Vanity	Whitehurst	F
Cass	Whiteley	M
Josias	Whiteman	M
Shamara	Whitener	F
Shonta	Whiteside	F
Skylynn	Whitfield	F
Lyndi	Whitford	F
Alvena	Whiting	F
Azalia	Whitley	F
Brooklynne	Whitlock	F
Cletis	Whitlow	M
Grisel	Whitman	F
Kyren	Whitmer	M
Modesta	Whitmire	F
Zulma	Whitmore	F
Chenoa	Whitney	F
Jasleen	Whitson	F
Jc	Whitt	M
Kalob	Whittaker	M
Kathey	Whittemore	F
Veva	Whitten	F
Zamir	Whittington	M
Alexzandria	Whittle	F
Lorianne	Whitworth	F
Laith	Whyte	M
Shyanna	Wick	F
Burnice	Wicker	F
Courtnee	Wickham	F
Dawayne	Wicks	M
Lucus	Widener	M
Cam	Wiegand	M
Clemens	Wieland	M
Jessee	Wiener	M
Romello	Wiese	M
Priyanka	Wiggins	F
Nicolina	Wight	F
Virgina	Wilbanks	F
Jerron	Wilber	M
Keyara	Wilborn	F
Denese	Wilbur	F
Hermina	Wilburn	F
Liesl	Wilcox	F
Osborne	Wild	M
Tanvi	Wilde	F
Zaina	Wilder	F
Huy	Wildman	M
Kamil	Wiles	M
Aston	Wiley	M
Markia	Wilfong	F
Neena	Wilhelm	F
Cristiano	Wilhite	M
Tayden	Wilk	M
Bernardino	Wilke	M
Celene	Wilkerson	F
Dolan	Wilkes	M
Dulcie	Wilkie	F
Sahana	Wilkins	F
Sina	Wilkinson	F
Sarrah	Wilks	F
Willaim	Will	M
Darryn	Willard	M
Gidget	Willett	F
Otilia	Willey	F
Tobey	William	M
Wheeler	Williams	M
Evander	Williamson	M
Joya	Willie	F
Minda	Williford	F
Vivianne	Willingham	F
Dagmar	Willis	F
Floria	Willoughby	F
Latoyia	Wills	F
Laurin	Willson	F
Carmello	Wilmot	M
Elenore	Wilmoth	F
Faisal	Wilson	M
Jamarius	Wilt	M
Lary	Wimberly	M
Dalene	Wimmer	F
Anaiya	Winchell	F
Cheyann	Winchester	F
Sania	Winder	F
Camie	Windham	F
Milla	Windsor	F
Yasir	Wine	M
Mekayla	Winfield	F
Renetta	Winfrey	F
Shereen	Wing	F
Zyaire	Wingard	M
Jene	Wingate	F
Mervyn	Winger	M
Shantae	Wingfield	F
Terresa	Wingo	F
Carmon	Winkler	F
Sparkle	Winn	F
Tamiya	Winslow	F
Clementina	Winstead	F
Hazen	Winston	M
Jubilee	Winter	F
Kaniyah	Winters	F
Lionell	Wirth	M
Raeanna	Wisdom	F
Dyanna	Wise	F
Kayne	Wiseman	M
Ladawn	Wisniewski	F
Janean	Witcher	F
Jaslynn	Withers	F
Persephone	Witherspoon	F
Ula	Withrow	F
Zakia	Witkowski	F
Ambrosia	Witmer	F
Jerell	Witt	M
Lotus	Witte	F
Gala	Wittman	F
Leonie	Wofford	F
Jahlil	Wojciechowski	M
Lillyann	Wojcik	F
Talen	Wolcott	M
Abhinav	Wold	M
Little	Wolf	M
Shemeka	Wolfe	F
Haydn	Wolff	M
Burnett	Wolford	M
Fatoumata	Wolter	F
Kiyah	Womack	F
Nyssa	Womble	F
Gracen	Wong	F
Leyna	Woo	F
Dorthey	Wood	F
Jacquez	Woodall	M
Yehoshua	Woodard	M
Zoee	Woodbury	F
Marjean	Woodcock	F
Raylynn	Wooden	F
Sheryll	Woodford	F
Leonia	Woodley	F
Wilhelm	Woodman	M
Jeronimo	Woodring	M
Sherree	Woodruff	F
Gaynelle	Woods	F
Janely	Woodson	F
Manning	Woodward	M
Teddi	Woodworth	F
Vikram	Woody	M
Lashae	Woolard	F
Baleigh	Wooldridge	F
Lisandra	Wooley	F
Macee	Woolf	F
Rebeccah	Woolley	F
Tyeisha	Woolsey	F
Jama	Wooten	F
Laveta	Word	F
Maleek	Worden	M
Marye	Workman	F
Rony	Worley	M
Rufino	Worrell	M
Indigo	Worsham	F
Javaris	Worth	M
Noemy	Wortham	F
Adara	Worthington	F
Demian	Worthy	M
Jerred	Wortman	M
Maksim	Wozniak	M
Myisha	Wray	F
Shenita	Wren	F
Siara	Wrenn	F
Amarie	Wright	F
Ayush	Wrobel	M
Ajani	Wroblewski	M
Lynnea	Wu	F
Nikolaos	Wulf	M
Bernell	Wyant	M
Brienna	Wyatt	F
Jahmir	Wyche	M
Tavin	Wyckoff	M
Kiona	Wylie	F
Maricella	Wyman	F
Missouri	Wynn	F
Paden	Wynne	M
Bailie	Wyrick	F
Geoff	Wysocki	M
Mariajose	Xie	F
Koda	Xiong	M
Benigno	Xu	M
Hassie	Yager	F
Martel	Yamada	M
Mattea	Yamamoto	F
Vertie	Yan	F
Nyree	Yancey	F
Dajon	Yancy	M
Dimas	Yanez	M
Ela	Yang	F
Esha	Yao	F
Sunnie	Yarborough	F
Tallulah	Yarbrough	F
Laquanda	Yates	F
Medina	Yazzie	F
Michala	Ybarra	F
Rebekkah	Ye	F
Gamaliel	Yeager	M
Daymon	Yee	M
Jacari	Yeh	M
Seneca	Yen	M
Zacharia	Yepez	M
Aislynn	Yeung	F
Aren	Yi	M
Florrie	Yim	F
Darry	Yin	M
Quanisha	Yingling	F
Tameika	Yip	F
Gricelda	Yocum	F
Lashon	Yoder	F
Nahum	Yoo	M
Niklas	Yoon	M
Verenice	York	F
Adora	Yost	F
Hermine	Youmans	F
Jani	Young	F
Ananda	Youngblood	F
Sandro	Younger	M
Zenia	Youngs	F
Geena	Yount	F
Park	Yu	M
Algie	Yuan	M
Darlena	Yuen	F
Efrem	Yun	M
Maja	Yung	F
Mathilde	Zachary	F
Xena	Zahn	F
Derry	Zajac	M
Gabrial	Zak	M
Kohl	Zamarripa	M
Marisha	Zambrano	F
Shaelynn	Zamora	F
Taha	Zamudio	M
Arno	Zander	M
Bebe	Zapata	F
Jacquie	Zaragoza	F
Brylie	Zarate	F
Karely	Zavala	F
Margy	Zayas	F
Robbi	Zeigler	F
Hadleigh	Zelaya	F
Jayquan	Zeller	M
Joannie	Zepeda	F
Ronell	Zhang	M
Salman	Zhao	M
Donnetta	Zheng	F
Joely	Zhou	F
Stefon	Zhu	M
Alaric	Zia-ul-Haq	M
Izzabella	Ziegler	F
Lasandra	Zielinski	F
Louetta	Zimmer	F
Abigael	Zimmerman	F
Giacomo	Zimmermann	M
Johney	Zink	M
Taneka	Zinn	F
Tommi	Zito	F
Bonifacio	Zook	M
Gavino	Zorn	M
Loreal	Zuniga	F
